olivia vinckier a colorful case for outsidethebox thinking on identity	outsidethebox_identity
john biewen the lie that invented racism	john_biewen
hasan kwame jeffries why we must confront the painful parts of us history	hasan_confront_history
brittney cooper the racial politics of time	time
dena simmons how students of color confront impostor syndrome	confront_syndrome
victor rios help for kids the education system ignores	kids_education
sal khan lets teach for mastery not test scores	khan_mastery
sal khan lets use video to reinvent education	khan_education
jon bergmann just how small is an atom	jon_bergmann_atom
tierney thys and plankton chronicles project the secret life of plankton	plankton
ayana elizabeth johnson and jennifer jacquet will the ocean ever run out of fish	ayana_elizabeth_johnson_jacquet_ocean_fish
ayana elizabeth johnson and megan davis underwater farms vs climate change	ayana_elizabeth_johnson_megan_davis_climate_change
emma bryce what really happens to the plastic you throw away	bryce_plastic
balsher singh sidhu are we running out of clean water	singh_water
dan kwartler what would happen if every human suddenly disappeared	dan
congrui jin what if cracks in concrete could fix themselves	congrui_jin
kim preshoff whats a smartphone made of	kim_preshoff
bandi mbubi demand a fair trade cell phone	bandi_mbubi
george ayittey africas cheetahs versus hippos	george_ayittey_africas
ngozi okonjoiweala aid versus trade	okonjoiweala
jacqueline novogratz invest in africas own solutions	jacqueline_novogratz_africas
sangu delle in praise of macro yes macro finance in africa	sangu_delle_africa
euvin naidoo why invest in africa	euvin_naidoo_africa
ngozi okonjoiweala want to help africa do business here	okonjoiweala_africa_business
eleni gabremadhin a commodities exchange for ethiopia	ethiopia
william kamkwamba how i built a windmill	william_windmill
corneille ewango a hero of the congo forest	corneille_congo
bill strickland rebuilding a neighborhood with beauty dignity hope	strickland
mitchell joachim dont build your home grow it	mitchell
rachel armstrong architecture that repairs itself	rachel_armstrong_architecture
juan enriquez using biology to rethink the energy challenge	juan_energy
david keith a critical look at geoengineering against climate change	david_keith_climate_change
john doerr salvation and profit in greentech	john_doerr
al gore new thinking on the climate crisis	al_gore_climate
alex steffen the route to a sustainable future	alex_steffen
william mcdonough cradle to cradle design	william_design
liz diller the blur building and other techempowered architecture	architecture
joshua princeramus behind the design of seattles library	joshua_princeramus_library_design
joshua princeramus building a theater that remakes itself	joshua_princeramus_theater
bjarke ingels 3 warpspeed architecture tales	architecture
philippe starck design and destiny	philippe_starck_design
stefan sagmeister happiness by design	stefan_happiness_design
stefan sagmeister things ive learned in my life so far	stefan
john maeda designing for simplicity	john
amy smith simple designs to save a life	smith
jonathan trent energy from floating algae pods	jonathan_energy
bilal bomani plant fuels that could power a jet	bomani
lisa margonelli the political chemistry of oil	lisa_margonelli
carl safina the oil spills unseen villains and victims	carl_safina
jeremy jackson how we wrecked the ocean	jackson_ocean
mike degruy hooked by an octopus	mike_octopus
david gallo underwater astonishments	david
sheila patek the shrimp with a kick	sheila
deborah gordon the emergent genius of ant colonies	deborah_gordon_ant
eo wilson my wish build the encyclopedia of life	encyclopedia
jane goodall how humans and animals can live together	goodall_animals
susan savagerumbaugh the gentle genius of bonobos	susan
isabel behncke evolutions gift of play from bonobo apes to humans	behncke
stuart brown play is more than just fun	brown
gever tulley 5 dangerous things you should let your kids do	gever_tulley_kids
sir ken robinson do schools kill creativity	ken_creativity
the interview sir ken robinson still wants an education revolution ted	ken_education_ted
sir ken robinson bring on the learning revolution	ken
sir ken robinson how to escape educations death valley	ken_valley
geoffrey canada our failing schools enough is enough	geoffrey_canada
rita pierson every kid needs a champion	rita_pierson
stephen ritz a teacher growing green in the south bronx	stephen_ritz_green_bronx
jamie oliver teach every child about food	jamie_oliver_food
dean ornish the killer american diet thats sweeping the planet	american_diet
ann cooper whats wrong with school lunches	ann
michael pollan a plantseye view	michael
paul stamets 6 ways mushrooms can save the world	paul
ron eglash the fractals at the heart of african designs	ron_african
janine benyus biomimicrys surprising lessons from natures engineers	janine
robert full robots inspired by cockroach ingenuity	robert_robots
dean kamen luke a new prosthetic arm for soldiers	luke
alan russell the potential of regenerative medicine	alan_russell_medicine
paul root wolpe its time to question bioengineering	paul
edith widder the weird wonderful world of bioluminescence	edith
richard pyle a dive into the reefs twilight zone	richard
nathan wolfe the jungle search for viruses	nathan
wade davis dreams from endangered cultures	wade_davis
wade davis the worldwide web of belief and ritual	wade_davis
david griffin how photography connects us	david_photography
stephen wilkes the passing of time caught in a single photo	stephen_time
paul nicklen animal tales from icy wonderlands	paul
rick smolan the story of a girl	rick
phil borges photos of endangered cultures	phil
jimmy nelson gorgeous portraits of the worlds vanishing people	nelson
sebastio salgado the silent drama of photography	salgado_photography
lisa kristine photos that bear witness to modern slavery	lisa_slavery
kevin bales how to combat modern slavery	kevin_slavery
jacqueline novogratz an escape from poverty	jacqueline_novogratz_poverty
jacqueline novogratz patient capitalism	jacqueline_novogratz
paul collier the bottom billion	paul
hans rosling new insights on poverty	poverty
talithia williams own your bodys data	talithia_williams_data
gary wolf the quantified self	gary_wolf
sam martin claim your manspace	sam_martin
adam savage my obsession with objects and the stories they tell	adam
nathan myhrvold archaeology animal photography bbq	nathan_bbq_archaeology_photography
clifford stoll the call to learn	clifford
neil gershenfeld unleash your creativity in a fab lab	neil_fab
saul griffith everyday inventions	saul
yves bhar designing objects that tell stories	bhar
ross lovegrove organic design inspired by nature	ross_design_nature
elora hardy magical houses made of bamboo	elora
marc kushner why the buildings of the future will be shaped by you	kushner
thom mayne how architecture can connect us	mayne_architecture
cameron sinclair my wish a call for opensource architecture	architecture
alastair parvin architecture for the people by the people	parvin_architecture
jimmy wales the birth of wikipedia	wikipedia
jonathan zittrain the web as random acts of kindness	jonathan
steven pinker the surprising decline in violence	steven_violence
robert wright progress is not a zerosum game	robert
martin rees is this our final century	martin
stephen petranek 10 ways the world could end	stephen_petranek
ron shaneyfelt is space trying to kill us	ron_space
fabio pacucci could the earth be swallowed by a black hole	fabio_pacucci
venus keus three ways the universe could end	universe
sajan saini what is the universe expanding into	sajan_saini_universe
david lunney the life cycle of a neutron star	david_star
andrew zimmerman jones does time exist	andrew_jones_time
chris anderson questions no one knows the answers to ted	chris_anderson_ted
chris anderson how web video powers global innovation	chris_anderson_global_innovation
sugata mitra the childdriven education	mitra_education
sugata mitra kids can teach themselves	mitra_kids
sugata mitra build a school in the cloud	mitra_cloud
shukla bose teaching one child at a time	teaching
kiran sethi kids take charge	kiran_kids
sunitha krishnan the fight against sex slavery	sunitha_krishnan_sex_slavery
eve ensler happiness in body and soul	happiness
amy tan where does creativity hide	tan
maira kalman the illustrated woman	maira
isaac mizrahi fashion and creativity	isaac_fashion_creativity
jj abrams the mystery box	abrams
jeff skoll my journey into movies that matter	jeff_skoll
deborah scranton an iraq war movie crowdsourced from soldiers	deborah_scranton_iraq_war
newton aduaka the story of ezra	newton_aduaka_ezra
chris abani on humanity	chris_abani_humanity
chris abani telling stories from africa	chris_abani_africa
ory okolloh how i became an activist	okolloh
bono my wish three actions for africa	africa
neil turok my wish find the next einstein in africa	neil_africa
dave eggers my wish once upon a school	dave
diana laufenberg how to learn from mistakes	diana_laufenberg
taylor mali what teachers make	taylor
michael shermer why people believe weird things	michael
david deutsch a new way to explain explanation	david
david deutsch chemical scum that dream of distant quasars	david_chemical
jedidah isler how i fell in love with quasars blazars and our incredible universe	jedidah_universe
fred jansen how to land on a comet	jansen_comet
burt rutan the real future of space exploration	rutan_space
robert ballard the astonishing hidden world of the deep ocean	robert_ballard_ocean
carolyn porco this is saturn	porco
carolyn porco could a saturn moon harbor life	porco
freeman dyson lets look for life in the outer solar system	freeman_dyson
george smoot the design of the universe	george_design
chris hadfield what i learned from going blind in space	chris_hadfield_space
brian cox why we need the explorers	brian
brian cox what went wrong at the lhc	brian
brian cox cerns supercollider	brian
brian greene making sense of string theory	brian_greene_string_theory
patricia burchat shedding light on dark matter	patricia_dark_matter
henry lin what we can learn from galaxies far far away	lin
beeban kidron the shared wonder of film	kidron_film
jehane noujaim my wish a global day of film	global_film
chris milk how virtual reality can create the ultimate empathy machine	chris_virtual_reality
aaron koblin visualizing ourselves with crowdsourced data	aaron_koblin_data
joann kucheramorin stunning data visualization in the allosphere	joann_kucheramorin
christopher decharms a look inside the brain in real time	christopher_brain
vs ramachandran 3 clues to understanding your brain	ramachandran_brain
al seckel visual illusions that show how we misthink	al
vik muniz art with wire sugar chocolate and string	art
theo jansen my creations a new form of life	jansen
arthur ganson moving sculpture	arthur_ganson
jonathan harris the webs secret stories	jonathan_harris
jonathan harris the web as art	jonathan_harris_art
golan levin software as art	levin_software_art
jakob trollback a new kind of music video	jakob_music
vusi mahlasela thula mama	mahlasela_mama
vusi mahlasela woza	mahlasela_woza
raul midon tembererana	raul_midon
raul midon peace on earth	raul_midon
jill sobule global warmings theme song manhattan in january	jill_manhattan_january
jill sobule julia sweeney the jill and julia show	jill
julia sweeney letting go of god	god
dan dennett lets teach religion all religion in schools	dan_dennett_religion
rick warren a life of purpose	rick_warren
feisal abdul rauf lose your ego find your compassion	rauf_ego_compassion
dayananda saraswati the profound journey of compassion	dayananda_saraswati_compassion
james forbes compassion at the dinner table	james_compassion
robert wright the evolution of compassion	robert_evolution_compassion
jackie tabick the balancing act of compassion	jackie_act_compassion
krista tippett reconnecting with compassion	krista_tippett_compassion
karen armstrong my wish the charter for compassion	karen_armstrong
robert thurman we can be buddhas	robert_thurman
matthieu ricard the habits of happiness	matthieu_happiness
billy graham on technology and faith	graham_technology
tom honey why would god create a tsunami	tom_god
kwame anthony appiah is religion good or bad this is a trick question	anthony_appiah_religion
alain de botton atheism 20	botton_atheism
alain de botton a kinder gentler philosophy of success	botton_philosophy_success
elizabeth gilbert your elusive creative genius	elizabeth_gilbert
janet echelman taking imagination seriously	echelman
steve jobs how to live before you die	steve
simon sinek how great leaders inspire action	simon_sinek
simon sinek why good leaders make you feel safe	simon_sinek
drew dudley everyday leadership	leadership
daniel goleman why arent we more compassionate	goleman
joan halifax compassion and the true meaning of empathy	joan_compassion
dan pink the puzzle of motivation	dan_motivation
dan ariely are we in control of our own decisions	dan
dan ariely our buggy moral code	dan
dan gilbert why we make bad decisions	dan_gilbert
dan gilbert the surprising science of happiness	dan_gilbert_science_happiness
matt killingsworth want to be happier stay in the moment	matt_killingsworth
mihaly csikszentmihalyi flow the secret to happiness	happiness
martin seligman the new era of positive psychology	martin_seligman_psychology
barry schwartz the paradox of choice	barry
ruth chang how to make hard choices	chang
kathryn schulz dont regret regret	kathryn_regret
kathryn schulz on being wrong	kathryn
richard st john 8 secrets of success	richard_st_john_success
jia jiang what i learned from 100 days of rejection	jia_jiang
amy cuddy your body language may shape who you are	cuddy_body_language
bren brown the power of vulnerability	bren_brown_vulnerability
bren brown listening to shame	bren_brown
barry schwartz using our practical wisdom	barry
barry schwartz our loss of wisdom	barry
bernie dunlap the lifelong learner	bernie
john francis walk the earth my 17year vow of silence	john_francis
shaka senghor why your worst deeds dont define you	shaka
damon horowitz philosophy in prison	horowitz_philosophy_prison
nalini nadkarni life science in prison	nadkarni_prison
nalini nadkarni conserving the canopy	nadkarni_canopy
shubhendu sharma how to grow a forest in your backyard	sharma_backyard
richard preston the mysterious lives of giant trees	richard_preston_trees
rachel sussman the worlds oldest living things	rachel
edward burtynsky my wish manufactured landscapes and green education	edward_green
chris jordan turning powerful stats into art	chris_jordan_art
peter gabriel fight injustice with raw video	peter_gabriel
james nachtwey my wish let my photographs bear witness	james_nachtwey
janine di giovanni what i saw in the war	janine_giovanni_war
alberto cairo there are no scraps of men	cairo
inge missmahl bringing peace to the minds of afghanistan	afghanistan
emmanuel jal the music of a war child	emmanuel_music_war
gustavo dudamel and the teresa carreo youth orchestra el sistemas top youth orchestra	gustavo_dudamel_carreo_orchestra_el_sistemas
jos antonio abreu the el sistema music revolution	jos_antonio_el_music
benjamin zander the transformative power of classical music	benjamin_music
tod machover dan ellsey inventing instruments that unlock new music	dan_music
pamelia kurstin the untouchable music of the theremin	pamelia_kurstin_music
natalie macmaster cape breton fiddling in reel time	natalie_breton
sirena huang an 11yearolds magical violin	huang_violin
joey alexander an 11yearold prodigy performs oldschool jazz	joey
guy hoffman robots with soul	robots
bruno maisonnier dance tiny robots	bruno_robots
hod lipson building selfaware robots	lipson_robots
robert full the sticky wonder of gecko feet	robert
robert full the secrets of natures grossest creatures channeled into robots	robert_robots
marcus byrne the dance of the dung beetle	marcus_byrne_dung
charles anderson dragonflies that fly across oceans	anderson
dennis vanengelsdorp a plea for bees	vanengelsdorp_bees
marla spivak why bees are disappearing	bees
noah wilsonrich every city needs healthy honey bees	noah_wilsonrich_bees
shimon steinberg natural pest control using bugs	shimon_steinberg_pest
cheryl hayashi the magnificence of spider silk	hayashi
janine benyus biomimicry in action	janine_biomimicry
michael pawlyn using natures genius in architecture	michael_pawlyn_architecture
arthur potts dawson a vision for sustainable restaurants	arthur
tristram stuart the global food waste scandal	tristram_food
pam warhurst how we can eat our landscapes	pam_warhurst
cary fowler one seed at a time protecting the future of food	cary_food
jonathan drori why were storing billions of seeds	jonathan
ameenah guribfakim humble plants that hide surprising secrets	ameenah_guribfakim_plants
kenny coogan the wild world of carnivorous plants	kenny_plants
anne gaskett the sexual deception of orchids	anne_gaskett
anika hazra a simple way to tell insects apart	insects
alex gendler why elephants never forget	alex
matthew borths claws vs nails	matthew_claws
judy cebrathomas how turtle shells evolved twice	judy_turtle
scott gass the survival of the sea turtle	scott_gass_turtle
jennifer verduin how do ocean currents work	ocean
darren croft inside the killer whale matriarchy	darren
stephanie sardelis why do whales sing	stephanie
asha de vos why you should care about whale poo	asha
sylvia earle my wish protect our oceans	sylvia_earle
craig venter sampling the oceans dna	craig_dna
craig venter on the verge of creating synthetic life	craig
paul ewald can we domesticate germs	paul_ewald
paul rothemund dna folding in detail	paul_dna
david bolinsky visualizing the wonder of a living cell	david
james watson how we discovered dna	james_watson_dna
murray gellmann beauty truth and physics	gellmann_physics
marcus du sautoy symmetry realitys riddle	marcus_du_sautoy
garrett lisi an 8dimensional model of the universe	garrett
james beacham how we explore unanswered questions in physics	james_beacham_physics
brian greene is our universe the only universe	brian_greene_universe
stephen hawking questioning the universe	stephen_universe
richard dawkins why the universe seems so strange	richard_universe
robin ince science versus wonder	science
douglas adams parrots the universe and everything	douglas
john lloyd an inventory of the invisible	john_lloyd
sarah jones a onewoman global village	sarah_jones
anna deavere smith four american characters	anna_smith_american
nora york singing what i want	nora_york
eddi reader kiteflyers hill	hill
rokia traore kounandi	kounandi
andrew bird a oneman orchestra of the imagination	andrew_orchestra
david byrne ethel thomas dolby nothing but flowers with string quartet	david_byrne_ethel_thomas_dolby
david byrne how architecture helped music evolve	david_byrne_architecture_music
qi zhang an electrifying organ performance	zhang_performance
jennifer lin improvising on piano aged 14	lin
daria van den bercken why i take the piano on the road and in the air	daria_van_bercken
john q walker great piano performances recreated	john
derek paravicini and adam ockelford in the key of genius	adam
faith jegede cole what ive learned from my autistic brothers	cole
elyn saks a tale of mental illness from the inside	elyn_tale_mental
sherwin nuland how electroshock therapy changed me	sherwin
sherwin nuland the extraordinary power of ordinary people	sherwin
robert thurman expanding your circle of compassion	robert_thurman_compassion
chademeng tan everyday compassion at google	chademeng_tan_google
karen armstrong lets revive the golden rule	karen_armstrong
andrew solomon depression the secret we share	andrew_solomon_depression
kevin breel confessions of a depressed comic	kevin
ruby wax whats so funny about mental illness	ruby_mental
joshua walters on being just crazy enough	joshua
becky blanton the year i was homeless	blanton
david hoffman what happens when you lose everything	david
carl honor in praise of slowness	carl
carl honor why we should embrace aging as an adventure	carl_aging
paul tasner how i became an entrepreneur at 66	paul_tasner_entrepreneur
jeff kirschner this app makes it fun to pick up litter	jeff
melati and isabel wijsen our campaign to ban plastic bags in bali	melati_wijsen_plastic
van jones the economic injustice of plastic	van_jones_plastic
mike biddle we can recycle plastic	mike_plastic
charles moore seas of plastic	moore_plastic
dianna cohen tough truths about plastic pollution	dianna_cohen_plastic
david katz the surprising solution to ocean plastic	david_katz_ocean_plastic
thomas thwaites how i built a toaster from scratch	thomas
matt ridley when ideas have sex	matt
charles leadbeater the era of open innovation	innovation
howard rheingold the new power of collaboration	howard_rheingold_collaboration
clay shirky institutions vs collaboration	collaboration
yochai benkler the new opensource economics	yochai_economics
philip rosedale life in second life	philip
meron gribetz a glimpse of the future through an augmented reality headset	meron_augmented_reality
ray kurzweil the accelerating power of technology	kurzweil_technology
kevin kelly how technology evolves	kevin_kelly_technology
kevin kelly the next 5000 days of the web	kevin_kelly_web
steven johnson the web as a city	steven_johnson
chris anderson technologys long tail	chris_anderson
sergey brin larry page the genesis of google	sergey_brin_larry_google
sebastian thrun googles driverless car	driverless
vijay kumar robots that fly and cooperate	vijay_kumar_robots
adam grant the surprising habits of original thinkers	adam
adam grant are you a giver or a taker	adam
shonda rhimes my year of saying yes to everything	shonda
sebastian wernicke how to use data to make a hit tv show	data
lauren zalaznick the conscience of television	lauren_television
cynthia schneider the surprising spread of idol tv	cynthia_idol
shashi tharoor why nations should pursue soft power	shashi
hans rosling asias rise how and when	asias
hans rosling insights on hiv in stunning data visuals	hiv
joe derisi solving medical mysteries	joe
ben longdon how do viruses jump from animals to humans	ben_longdon_animals
melvin sanicas what makes tb the worlds most infectious killer	melvin
philip a chan how close are we to eradicating hiv	philip_chan_hiv
emma bryce what is hpv and how can you protect yourself from it	bryce_hpv
nassim assefi and brian a levine how in vitro fertilization ivf works	assefi_brian
emma bryce how does the thyroid manage your metabolism	bryce
melvin sanicas why is meningitis so dangerous	melvin_meningitis
rusha modi what causes heartburn	rusha
akash manoj a lifesaving device that detects silent heart attacks	manoj_heart
franz freudenthal a new way to heal hearts without surgery	franz_freudenthal_surgery
catherine mohr surgerys past present and robotic future	catherine
steven schwaitzberg a universal translator for surgeons	steven_schwaitzberg
quyen nguyen colorcoded surgery	surgery
deborah rhodes a test that finds 3x more breast tumors and why its not available to you	deborah
jay bradner opensource cancer research	jay_cancer_research
david agus a new strategy in the war on cancer	david_cancer
eva vertes meet the future of cancer research	eva_cancer
jorge soto the future of early cancer detection	cancer
jack andraka a promising test for pancreatic cancer from a teenager	jack_teenager_cancer
taylor wilson yup i built a nuclear fusion reactor	taylor_nuclear
lauren hodge shree bose naomi shah awardwinning teenage science in action	lauren_hodge_science
natalie warne being young and making an impact	natalie
stefan wolff the path to ending ethnic conflicts	stefan
asher hasan my message of peace from pakistan	asher_hasan_pakistan
erik hersman reporting crisis via texting	erik_hersman
iqbal quadir how mobile phones can fight poverty	iqbal_quadir_poverty
nicholas negroponte one laptop per child two years on	negroponte
nicholas negroponte 5 predictions from 1984	negroponte
nicholas negroponte a 30year history of the future	negroponte_future
nicholas negroponte one laptop per child	negroponte
charles leadbeater education innovation in the slums	education_innovation
geoff mulgan a short intro to the studio school	intro
adora svitak what adults can learn from kids	adora_svitak_kids
julie lythcotthaims how to raise successful kids without overparenting	julie_kids
sajay samuel how college loans exploit students for profit	samuel
daphne koller what were learning from online education	daphne_education
peter norvig the 100000student classroom	peter
ray kurzweil a university for the coming singularity	kurzweil
laurie garrett lessons from the 1918 flu	laurie_garrett_flu
larry brilliant my wish help me stop pandemics	larry
bruce aylward how well stop polio for good	bruce_aylward_polio
james nachtwey moving photos of extreme drugresistant tb	james_nachtwey
kristen ashburn the face of aids in africa	africa_aids
annie lennox why i am an hivaids activist	annie
mitchell besser mothers helping mothers fight hiv	mitchell_hiv
elizabeth pisani sex drugs and hiv lets get rational	elizabeth_hiv_sex
emily oster flip your thinking on aids in africa	africa_aids
peter donnelly how juries are fooled by statistics	peter_statistics
robert full learning from the geckos tail	robert
dennis hong my seven species of robot and how we created them	hong
yves rossy fly with the jetman	jetman
anna mracek dietrich a plane you can drive	anna_mracek
chris bangle great cars are great art	chris_art
jennifer healey if cars could accidents might be avoidable talk	healey_cars
chris gerdes the future race car 150mph and no driver	chris_driver_future
larry burns the future of cars	larry_future
elon musk the future were building and boring	elon_future
elon musk the mind behind tesla spacex solarcity	elon_tesla
shai agassi a new ecosystem for electric cars	shai_agassi_electric
saul griffith highaltitude wind energy from kites	saul_wind_energy
paul maccready a flight on solar wings	paul_maccready_flight_solar
paul maccready nature vs humans	paul_maccready
bertrand piccard my solarpowered adventure	bertrand
richard branson life at 30000 feet	richard_branson
malcolm gladwell choice happiness and spaghetti sauce	malcolm_gladwell
seth godin how to get your ideas to spread	seth
chieh huang confessions of a recovering micromanager	chieh_huang
john doerr why the secret to success is setting the right goals	john_doerr_success_goals
frances frei how to build and rebuild trust	trust
rachel botsman weve stopped trusting institutions and started trusting strangers	rachel
joe gebbia how airbnb designs for trust	joe_gebbia_trust
travis kalanick ubers plan to get more people into fewer cars	travis_cars
robert neuwirth the hidden world of shadow cities	robert_cities
taryn simon photographs of secret sites	taryn_simon
scott fraser why eyewitnesses get it wrong	scott_fraser
bryan stevenson we need to about an injustice talk	bryan
aaron huey americas native prisoners of war	aaron
gary haugen the hidden reason for poverty the world needs to address now	gary_poverty
jacqueline novogratz a third way to think about aid	jacqueline_novogratz
bill clinton my wish rebuilding rwanda	clinton_rwanda
seyi oyesola a hospital tour in nigeria	oyesola_nigeria
joseph lekuton a parable for kenya	joseph_lekuton_kenya
dolores huerta how to overcome apathy and find your power	huerta
marian wright edelman reflections from a lifetime fighting to end child poverty	poverty
stacey abrams 3 questions to ask yourself about everything you do	stacey_abrams
elif shafak the revolutionary power of diverse thought	shafak
elif shafak the politics of fiction	shafak_politics
adeola fayehun africa is a sleeping giant im trying to wake it up	fayehun_africa
wanjira mathai 3 ways to uproot a culture of corruption	wanjira_mathai_corruption
efosa ojomo reducing corruption takes a specific kind of investment	efosa_corruption
afra raymond three myths about corruption	raymond_corruption
peter eigen how to expose the corrupt	peter
sanjay pradhan how open data is changing international aid	sanjay_pradhan_data_international
ashraf ghani how to rebuild a broken state	ghani
michael metcalfe we need money for aid so lets print it	michael_metcalfe
jamie drummond lets crowdsource the worlds goals	jamie_goals
manuel lima a visual history of human knowledge	manuel_lima
david mccandless the beauty of data visualization	david_data
gary flake is pivot a turning point for web exploration	gary
blaise agera y arcas how photosynth can connect the worlds images	y_photosynth
johnny lee free or cheap wii remote hacks	lee
anand agarawala rethink the desktop with bumptop	anand
andrew connolly whats the next window into our universe	andrew_universe
carter emmart a 3d atlas of the universe	atlas
rene hlozek the death of the universe	hlozek_death_universe
james gillies dark matter the matter we cant see	james_dark_matter
gabriela gonzlez how ligo discovered gravitational waves and what might be next	gonzlez_ligo
allan adams what the discovery of gravitational waves means	allan
wendy freedman this telescope might show us the beginning of the universe	universe
sara seager the search for planets beyond our solar system	sara_planets_solar_system
nathalie cabrol how mars might hold the secret to the origin of life	nathalie_mars
charles elachi the story behind the mars rovers	elachi_mars
stephen petranek your kids might live on mars heres how theyll survive	stephen_petranek_mars
lucianne walkowicz lets not use mars as a backup planet	lucianne_mars
jeremy kasdin the flowershaped starshade that might help us detect earthlike planets	kasdin_planets
jill tarter join the seti search	jill
peter ward a theory of earths mass extinctions	peter
stefano mancuso the roots of plant intelligence	mancuso
bonnie bassler how bacteria talk	bacteria
margaret wertheim the beautiful math of coral	margaret_math_coral
kristen marhaver why i still have hope for coral reefs	coral_reefs
kristen marhaver how were growing baby corals to rebuild reefs	reefs
cesar harada how i teach kids to love science	harada
cesar harada a novel idea for cleaning up oil spills	harada
massimo banzi how arduino is opensourcing imagination	arduino
kate hartman the art of wearable communication	hartman_art_communication
camille seaman haunting photos of polar ice	seaman
james balog timelapse proof of extreme ice loss	james
ben saunders why did i ski to the north pole	ben
dame ellen macarthur the surprising thing i learned sailing solo around the world	macarthur
johan rockstrm let the environment guide our development	johan_environment
al gore what comes after an inconvenient truth	al_gore
al gore averting the climate crisis	al_gore_climate
ray anderson the business logic of sustainability	anderson_business_sustainability
steve howard lets go allin on selling sustainability	steve_howard_allin_sustainability
bjarke ingels hedonistic sustainability	sustainability
john hodgman design explained	john_hodgman_design
david carson design and discovery	david_carson_design
matthew carter my life in typefaces	matthew
aris venetikidis making sense of maps	aris_maps
dan dennett cute sexy sweet funny	dan_dennett
jonathan haidt the moral roots of liberals and conservatives	jonathan
jonathan haidt can a divided america heal	jonathan_america
alex edmans what to trust in a posttruth world	alex_trust
mona chalabi 3 ways to spot a bad statistic	mona
vanessa ruiz the spellbinding art of human anatomy	art_human
amit sood every piece of art youve ever wanted to see up close and searchable	piece_art
ursus wehrli tidying up art	art
ze frank nerdcore comedy	frank_comedy
john hodgman aliens love where are they	john_hodgman_aliens_love
colin stokes how movies teach manhood	colin
don levy a cinematic journey through visual effects	don
rob legato the art of creating awe	legato_art
andrew stanton the clues to a great story	andrew_stanton
james cameron before avatar a curious boy	james_avatar
ed ulbrich how benjamin button got his face	benjamin
paul debevec animating a photoreal digital face	paul_debevec
siegfried woldhek the search for the true face of leonardo	woldhek_leonardo
william noel revealing the lost codex of archimedes	william_noel
brewster kahle a free digital library	library
peter hirshberg the web is more than better tv	peter_hirshberg_web
chand john whats the fastest way to alphabetize your bookshelf	john_bookshelf
david j malan whats an algorithm	david_algorithm
jos amricano n l f de freitas how exactly does binary code work	jos_code
misha glenny hire the hackers	misha
misha glenny the real story of mcmafia how global crime networks work	misha_mcmafia_global_crime
rodrigo canales the deadly genius of drug cartels	rodrigo
bono the good news on poverty yes theres good news	poverty
hans rosling global population growth box by box	global
louise fresco we need to feed the whole world	fresco
homaro cantu ben roche cooking as alchemy	ben
barton seaver sustainable seafood lets get smart	barton_seaver
dan barber how i fell in love with a fish	dan
dan barber a foie gras parable	dan_gras
carolyn steel how food shapes our cities	food_cities
stewart brand what squatter cities can teach us	stewart_cities
james howard kunstler the ghastly tragedy of the suburbs	james_howard_kunstler
thomas barnett lets rethink americas military strategy	thomas_barnett_military
aubrey de grey a roadmap to end aging	aubrey_roadmap_aging
dean ornish healing through diet	diet
sandra aamodt why dieting doesnt usually work	sandra_aamodt
mick cornett how an obese town lost a million pounds	cornett
jeff speck the walkable city	jeff_speck
janette sadikkhan new yorks streets not so mean any more	janette_sadikkhan
gary lauder take turns	gary
taiye selasi dont ask where im from ask where im a local	selasi
tyler cowen be suspicious of simple stories	cowen
alex tabarrok how ideas trump crises	alex
bjorn lomborg global priorities bigger than climate change	lomborg_climate_change
jessica jackley poverty money and love	jessica_poverty
katherine fulton you are the future of philanthropy	katherine_fulton_philanthropy
chris mcknett the investment logic for sustainability	chris_mcknett_sustainability
shubhendu sharma an engineers vision for tiny forests everywhere	sharma
marcin jakubowski opensourced blueprints for civilization	jakubowski
dale dougherty we are makers	dougherty
gever tulley life lessons through tinkering	gever_tulley
arthur benjamin teach statistics before calculus	arthur_benjamin_statistics
liz coleman a call to reinvent liberal arts education	coleman_education
michelle obama a passionate personal case for education	michelle_education
hanna rosin new data on the rise of women	hanna_women
gayle tzemach lemmon women entrepreneurs example not exception	tzemach_women
courtney e martin this isnt her mothers feminism	courtney_martin_feminism
james stavridis a navy admirals thoughts on global security	james_navy_global
guyphilippe goldstein how cyberattacks threaten realworld peace	guyphilippe_goldstein
ralph langner cracking stuxnet a 21stcentury cyber weapon	ralph_cyber
bruce bueno de mesquita a prediction for the future of iran	bruce_mesquita_iran
noah feldman politics and religion are technologies	noah_feldman_politics_religion
dan dennett dangerous memes	dan_dennett
susan blackmore memes and temes	susan
dan dennett the illusion of consciousness	dan_dennett_illusion_consciousness
jeff hawkins how brain science will change computing	jeff_brain_science
kwabena boahen a computer that works like the brain	brain
jill bolte taylor my stroke of insight	jill_bolte_taylor
wendy suzuki the brainchanging benefits of exercise	exercise
lisa genova what you can do to prevent alzheimers	lisa_genova
cynthia kenyon experiments that hint of longer lives	cynthia_kenyon
juan enriquez the life code that will reshape the future	juan
barry schuler genomics 101	barry
craig venter watch me unveil synthetic life	craig_unveil
juan enriquez the next species of human	juan
juan enriquez will our kids be a different species	juan
sandrine thuret you can grow new brain cells heres how	thuret_brain
siddharthan chandran can the damaged brain repair itself	siddharthan_brain
michael merzenich growing evidence of brain plasticity	michael_brain
miguel nicolelis a monkey that controls a robot with its thoughts no really	miguel
carl schoonover how to look inside the brain	carl_brain
neil burgess how your brain tells you where you are	neil_brain
daniel wolpert the real reason for brains	wolpert
eve ensler suddenly my body	body
leymah gbowee unlock the intelligence passion greatness of girls	leymah
jody williams a realistic vision for world peace	williams
his holiness the karmapa the technology of the heart	karmapa
jeremy rifkin the empathic civilization	rifkin
jane fonda lifes third act	fonda_act
stephen friend the hunt for unexpected genetic heroes	stephen_hunt
john wilbanks lets pool our medical data	john_medical
ben goldacre what doctors dont know about the drugs they prescribe	ben_drugs
abraham verghese a doctors touch	abraham
bill davenhall your health depends on where you live	health
parag khanna mapping the future of countries	parag_khanna
gordon brown wiring a web for global good	gordon_brown_global
gordon brown global ethic vs national interest	gordon_brown_national_global
christiana figueres the inside story of the paris climate agreement	christiana_paris_climate
mary robinson why climate change is a threat to human rights	mary_climate_change
antonio donato nobre the magic of the amazon a river that flows invisibly all around us	antonio_donato_nobre_amazon
enric sala glimpses of a pristine ocean	sala_ocean
edith widder glowing life in an underwater world	edith
edith widder how we found the giant squid	edith
david gallo life in the deep oceans	david
john c moore and eric berlow dead stuff the secret ingredient in our food chain	john_moore_eric_food
emma bryce should we eat bugs	bryce
rose eveleth the loathsome lethal mosquito	eveleth_mosquito
carl zimmer how did feathers evolve	carl
gillian gibb why cant some birds fly	gillian_birds
rebecca tarvin why dont poisonous animals poison themselves	tarvin_animals
eldridge adams can animals be deceptive	animals
tony buffington why do cats act so weird	tony_buffington_act
evamaria geigl the history of the world according to cats	evamaria_history
chris a kniesly history through the eyes of a chicken	chris_history
paul s kindstedt a brief history of cheese	paul_kindstedt_history
keith eggener the fascinating history of cemeteries	keith_history
joy lin if superpowers were real immortality	lin
joy lin if superpowers were real flight	lin_flight
joy lin if superpowers were real body mass	lin
joy lin if superpowers were real super speed	lin
joy lin if superpowers were real invisibility	lin
michael mauser what are those floaty things in your eye	michael_mauser_floaty
alex gendler why do we cry the three types of tears	alex
douglas l oliver the science of hearing	douglas_oliver_science_hearing
susan emmett this simple test can help kids hear better	susan_emmett
sarah parcak help discover ancient ruins before its too late	sarah_ancient
sarah parcak hunting for perus lost civilizations with satellites	sarah_perus
sarah parcak archaeology from space	sarah_archaeology_space
ben kacyra ancient wonders captured in 3d	ben_kacyra
david christian the history of our world in 18 minutes	david_christian_history
kevin kelly technologys epic story	kevin_kelly
douglas rushkoff how to be team human in the digital future	douglas_rushkoff
zeynep tufekci were building a dystopia just to make people click on ads	zeynep
zeynep tufekci machine intelligence makes human morals more important	zeynep_machine
blaise agera y arcas how computers are learning to be creative	y_learning
blaise agera y arcas augmentedreality maps	y_maps
stephen lawler tour microsofts virtual earth	stephen_virtual
malte spitz your phone company is watching	malte
roger mcnamee 6 ways to save the internet	roger_internet
clay shirky how social media can make history	social_media
evan williams the voices of twitter users	evan_williams
joseph pine what consumers want	joseph
robert neuwirth the power of the informal economy	robert
vinay venkatraman technology crafts for the digitally underserved	technology
aleph molinari lets bridge the digital divide	aleph_molinari_bridge
luis von ahn massivescale online collaboration	luis_von_massivescale_collaboration
adam ostrow after your final status update	adam
stefana broadbent how the internet enables intimacy	stefana
jan chipchase the anthropology of mobile phones	jan
paola antonelli design and the elastic mind	antonelli_design
paola antonelli treat design as art	antonelli_design_art
tim brown designers think big	tim_brown
tim brown tales of creativity and play	tim_brown_creativity
paula scher great design is serious not solemn	paula_scher_solemn_design
chip kidd designing books is no laughing matter ok it is	kidd
doris kearns goodwin lessons from past presidents	doris
richard sears planning for the end of oil	richard
t boone pickens lets transform energy with natural gas	energy
steven cowley fusion is energys future	steven
stewart brand 4 environmental heresies	stewart
michel laberge how synchronized hammer strikes could generate nuclear fusion	michel_nuclear
amory lovins a 40year plan for energy	energy
taylor wilson my radical plan for small nuclear fission reactors	taylor_nuclear
richard turere my invention that made peace with lions	richard
john kasaona how poachers became caretakers	john
boyd varty what i learned from nelson mandela	boyd_varty_nelson_mandela
bernie krause the voice of the natural world	bernie
louie schwartzberg the hidden beauty of pollination	schwartzberg_beauty
nick veasey exposing the invisible	nick
miru kim my underground art explorations	kim_art
dan barasch a park underneath the hustle and bustle of new york city	dan_hustle_york
robert hammond building a park in the sky	robert
david rockwell a memorial at ground zero	david
iwan baan ingenious homes in unexpected places	baan
anupam mishra the ancient ingenuity of water harvesting	mishra_water
tom wujec learn to use the 13thcentury astrolabe	tom_astrolabe
david hoffman sputnik mania	david_sputnik_mania
irwin redlener how to survive a nuclear attack	irwin
erika gregory the world doesnt need more nuclear weapons	erika_nuclear
joe lassiter we need nuclear power to solve climate change	joe_nuclear_climate_change
joi ito want to innovate become a nowist	joi_ito
regina dugan from mach20 glider to hummingbird drone	regina_hummingbird
paul moller my dream of a flying car	paul
graham hawkes a flight through the ocean	graham_ocean
scott gass how big is the ocean	scott_gass_ocean
alex gendler how tsunamis work	alex
nick pizzo the physics of surfing	nick_physics
brian d avery how rollercoasters affect your body	brian_body
arleen sugano the physics of the hardest move in ballet	arleen_physics
trevor copp and jeff fox ballroom dance that breaks gender roles	copp_jeff_fox_dance_gender
aakash odedra a dance in a hurricane of paper wind and light	odedra_dance
the lxd in the internet age dance evolves	lxd_dance
pilobolus a dance of symbiosis	dance
sofi tukker awoo	sofi
john legend redemption song	john
the lady lifers a moving song from women in prison for life	prison
jeff smith lessons in business from prison	jeff_smith_business_prison
dan pacholke how prisons can help inmates live meaningful lives	dan
peter ouko from death row to law graduate	peter_ouko_law
teresa njoroge what i learned serving time for a crime i didnt commit	njoroge
salil dudani how jails extort the poor	salil
alice goffman how were priming some kids for college and others for prison	prison
angela patton a fatherdaughter dance in prison	angela_patton_dance
steven addis a fatherdaughter bond one photo at a time	steven_addis
aicha elwafi phyllis rodriguez the mothers who found forgiveness friendship	aicha_elwafi_phyllis_rodriguez_friendship
sarah kaminsky my father the forger	sarah_kaminsky_father
alex gendler why should you read the master and margarita	alex_margarita
alex gendler why should you read crime and punishment	alex
silvia morenogarca titan of terror the dark imagination of hp lovecraft	silvia_titan
scott peeples why should you read edgar allan poe	scott_allan_poe
francisco dezbuzo why should you read one hundred years of solitude	francisco
iseult gillespie why should you read a midsummer nights dream	gillespie
iseult gillespie why should you read shakespeares the tempest	gillespie
iseult gillespie why should you read fahrenheit 451	gillespie
mia nacamulli why should you read kurt vonnegut	mia_nacamulli_kurt_vonnegut
ilan stavans why should you read don quixote	ilan_don
iseult gillespie why should you read flannery oconnor	gillespie_flannery
iseult gillespie the wicked wit of jane austen	gillespie
ayana jamieson and moya bailey why should you read scifi superstar octavia e butler	ayana_jamieson_moya_superstar
john mcwhorter are elvish klingon dothraki and navi real languages	john_dothraki
gina cooke why is there a b in doubt	gina_cooke
christopher warner what is verbal irony	christopher_warner
christopher warner situational irony the opposite of what you think	christopher_warner
noah tavlin what orwellian really means	noah_tavlin_orwellian
john koenig beautiful new words to describe obscure emotions	john_koenig_emotions
erin mckean go ahead make up new words	mckean
erin mckean the joy of lexicography	mckean
brendan constantine the opposites game	constantine
tim seibles first kiss	tim
iseult gillespie why should you read sylvia plath	gillespie_sylvia
sarah kay if i should have a daughter	sarah_kay
suheir hammad poems of war peace women power	hammad_war_women
kasiva mutua how i use the drum to tell my story	kasiva
tony porter a call to men	tony
jackson katz violence against women its a mens issue	jackson_katz_violence_women
leslie morgan steiner why domestic violence victims dont leave	morgan_steiner_violence
esta soler how we turned the tide on domestic violence hint the polaroid helped	esta_polaroid_violence
helen fisher the brain in love	helen_fisher_brain_love
helen fisher why we love why we cheat	helen_fisher_love
yann dallaglio love youre doing it wrong	yann_dallaglio_love
amy webb how i hacked online dating	webb
marc goodman a vision of crimes in the future	goodman_future
christopher moot poole the case for anonymity online	christopher_moot
kevin allocca why videos go viral	kevin
adam sadowsky how to engineer a viral music video	adam_music
miwa matreyek glorious visions in animation and performance	miwa_animation_performance
robert gupta joshua roman on violin and cello passacaglia	robert_joshua_violin_passacaglia
robert gupta music is medicine music is sanity	robert_music
julian treasure the 4 ways sound affects us	julian
tasos frantzolas everything you hear on film is a lie	film
meklit hadero the unexpected beauty of everyday sounds	hadero
honor harger a history of the universe in sound	sound
janna levin the sound the universe makes	janna_levin_universe
fabio pacucci can a black hole be destroyed	fabio_pacucci
sheperd doeleman inside the black hole image that made history	sheperd
carrie nugent adventures of an asteroid hunter	asteroid
phil plait how to defend earth from asteroids	phil_plait_defend
lucianne walkowicz finding planets around other stars	lucianne
dimitar sasselov how we found hundreds of potential earthlike planets	dimitar_planets
garik israelian how spectroscopy could reveal alien life	garik_alien
anjali tripathi why earth may someday look like mars	mars
lisa nip how humans could evolve to survive in space	lisa
aomawa shields how well find life on other planets	aomawa_planets
jedidah isler the untapped genius that could change science for the better	jedidah_science
rich benjamin my road trip through the whitest towns in america	benjamin_america
clint smith how to raise a black son in america	smith_america
clint smith the danger of silence	smith
lemon andersen please dont take my air jordans	andersen
rives a mockingbird remix of ted2006	remix
lee mokobe a powerful poem about what it feels like to be transgender	lee_poem_transgender
io tillett wright fifty shades of gay	tillett
lz granderson the myth of the gay agenda	lz
joel burns a message to gay teens it gets better	joel
benedetta berti did the global response to 911 make us safer	global
bobby ghosh why global jihad is losing	bobby_ghosh_jihad_global
mustafa akyol faith versus tradition in islam	mustafa_islam
naif almutawa superheroes inspired by islam	almutawa_islam
devdutt pattanaik east vs west the myths that mystify	devdutt_east_west
harsha bhogle the rise of cricket the rise of india	harsha_india
nandan nilekani ideas for indias future	nilekani_future
paul collier new rules for rebuilding a broken nation	paul
jonas gahr stre in defense of dialogue	gahr
carne ross an independent diplomat	ross
sheryl wudunn our centurys greatest injustice	sheryl_wudunn
kavita ramdas radical women embracing tradition	kavita_women
brenda laurel why not make video games for girls	brenda
david perry are games better than life	david
emmett shear what streaming means for the future of entertainment	emmett_entertainment
liv boeree 3 lessons on decisionmaking from a poker champion	liv_boeree
rajiv maheswaran the math behind basketballs wildest moves	rajiv_maheswaran_math
david epstein are athletes really getting faster better stronger	david
diana nyad extreme swimming with the worlds most dangerous jellyfish	diana
lewis pugh my mindshifting everest swim	lewis_everest
lewis pugh how i swam the north pole	lewis
ben saunders why bother leaving the house	ben
steve truglia a leap from the edge of space	steve_truglia_space
joy lin if superpowers were real super strength	lin
janine shepherd a broken body isnt a broken person	janine_shepherd_body
jennifer 8 lee the hunt for general tso	lee_hunt_tso
marcel dicke why not eat insects	insects
matilda ho the future of good food in china	matilda_ho_china_food
sara menker a global food crisis may be less than a decade away	sara_menker_global_food
pierre thiam a forgotten ancient grain that could help africa prosper	pierre_thiam_africa
olutimehin adegbeye who belongs in a city	olutimehin
laolu senbanjo the sacred art of the ori	art
titus kaphar can art amend history	titus_kaphar_art_history
michael murphy architecture thats built to heal	michael_architecture
ole scheeren why great architecture should tell a story	scheeren_architecture
moshe safdie how to reinvent the apartment building	moshe
xavier vilalta architecture at home in its community	xavier_architecture
norman foster my green agenda for architecture	norman_green_architecture
dbora mesa molina stunning buildings made from raw imperfect materials	dbora_molina
jeanne gang buildings that blend nature and city	jeanne_nature
neri oxman design at the intersection of technology and biology	neri_design_technology_biology
tony fadell the first secret of design is noticing	tony_fadell_design
aparna rao hightech art with a sense of humor	art_humor
alwar balasubramaniam art of substance and absence	alwar_balasubramaniam_art
mike matas a nextgeneration digital book	mike
shilo shiv suleman using tech to enable dreaming	shiv_suleman
joe sabia the technology of storytelling	joe_sabia_technology_storytelling
ze frank my web playroom	frank
megan washington why i live in mortal dread of public speaking	megan_washington
ck williams poetry of youth and age	williams_poetry
carmen agra deedy once upon a time my mother	agra
neil pasricha the 3 as of awesome	neil_pasricha
nancy etcoff happiness and its surprises	etcoff_happiness
daniel kahneman the riddle of experience vs memory	kahneman
michael green what the social progress index can reveal about your country	michael_green
simon anholt which country does the most good for the world	simon
simon anholt who would the rest of the world vote for in your countrys election	simon
halla tmasdttir its time for women to run for office	women
susan colantuono the career advice you probably didnt get	susan
sheryl sandberg why we have too few women leaders	sheryl_women
sheryl sandberg so we leaned in now what	sheryl
kakenya ntaiya a girl who demanded school	kakenya_ntaiya
shabana basijrasikh dare to educate afghan girls	shabana_afghan
sakena yacoobi how i stopped the taliban from shutting down my school	yacoobi_taliban
monika bulaj the hidden light of afghanistan	monika_afghanistan
zainab salbi women wartime and the dream of peace	salbi_women
rory stewart time to end the war in afghanistan	stewart_afghanistan_war
kimberley motley how i defend the rule of law	defend_law
karen tse how to stop torture	karen
michael sandel whats the right thing to do	michael_sandel
lawrence lessig laws that choke creativity	lessig_creativity
lawrence lessig reexamining the remix	lessig_remix
johanna blakley lessons from fashions free culture	johanna_culture
clay shirky why sopa is a bad idea	sopa
margaret gould stewart how youtube thinks about copyright	margaret_stewart
michael stevens how much does a video weigh	michael
randall munroe comics that ask what if	munroe
arthur benjamin a performance of mathemagic	arthur_benjamin_performance
keith barry brain magic	keith_barry_brain_magic
derren brown mentalism mind reading and the art of getting inside your head	derren_brown_art
bence nanay the end of history illusion	history_illusion
anita collins how playing an instrument benefits your brain	brain
elizabeth hellmuth margulis why we love repetition in music	elizabeth_hellmuth_music
betsy schwarm why should you listen to vivaldis four seasons	betsy
tim hansen how to read music	tim_music
annie bosler and don greene how to practice effectivelyfor just about anything	annie_don_greene
helen m farrell what is bipolar disorder	helen_farrell
temple grandin the world needs all kinds of minds	temple
steve silberman the forgotten history of autism	steve_history_autism
wendy chung autism what we know and what we dont know yet	chung_autism
ami klin a new way to diagnose autism	klin_autism
rosie king how autism freed me to be myself	autism
amos winter the cheap allterrain wheelchair	amos
cat laine engineering a better life for all	engineering
francis de los reyes sanitation is a basic human right	francis_los
rose george lets crap seriously talk	george
michael pritchard how to make filthy water drinkable	michael_pritchard_water
david kelley humancentered design	david_design
paul bennett design is in the details	paul_bennett_design
margaret gould stewart how giant websites design for you and a billion others too	margaret_stewart_design
sonaar luthra meet the water canary	luthra_water
rob harmon how to keep rivers and streams flowing	harmon_rivers
lana mazahreh 3 thoughtful ways to conserve water	water
david sedlak 4 ways we can avoid a catastrophic drought	david
fahad alattiya a country with no water	alattiya_water
alice bowslarkin climate change is happening heres how we adapt	bowslarkin_climate_change
pavan sukhdev put a value on nature	pavan
harish manwani profits not always the point	manwani
rachel botsman the case for collaborative consumption	rachel
eduardo paes the 4 commandments of cities	cities
benjamin barber why mayors should rule the world	benjamin
thelma golden how art gives shape to cultural change	art
nellie mckay clonie	nellie_mckay_clonie
nellie mckay the dog song	nellie_mckay
nellie mckay mother of pearl if i had you	nellie_mckay
charles hazlewood british paraorchestra the debut of the british paraorchestra	hazlewood_paraorchestra
mark ronson how sampling transformed music	ronson_music
kirby ferguson embrace the remix	kirby_remix
david kelley how to build your creative confidence	david
dan phillips creative houses from reclaimed stuff	dan
mac barnett why a good book is a secret door	mac_barnett
jarrett j krosoczka how a boy became an artist	jarrett_krosoczka
jarrett j krosoczka why lunch ladies are heroes	jarrett_krosoczka
mae jemison teach arts and sciences together	mae_jemison
john maeda how art technology and design inform creative leaders	john_art_technology_design
john maeda my journey in design	john_design
don norman 3 ways good design makes you happy	don_norman_design
richard seymour how beauty feels	richard_beauty
denis dutton a darwinian theory of beauty	dutton_beauty
steven pinker what our language habits reveal	steven_language
murray gellmann the ancestor of language	gellmann_language
eddy cartaya my glacier cave discoveries	eddy
francesco sauro deep under the earths surface discovering beauty and science	sauro_beauty_science
nathan wolfe whats left to explore	nathan
jessica green are we filtering the wrong microbes	jessica_green
catherine mohr the tradeoffs of building green	catherine_green
alex laskey how behavioral science can lower your energy bill	alex_behavioral_energy
keith chen could your language affect your ability to save money	keith_chen_language
melinda gates lets put birth control back on the agenda	melinda
mechai viravaidya how mr condom made thailand a better place for life and love	mechai_mr_condom_thailand
arunachalam muruganantham how i started a sanitary napkin revolution	arunachalam_muruganantham
nirmalya kumar indias invisible innovation	nirmalya_kumar_innovation
varun sivaram how india could pull off the worlds most ambitious energy transition	india_energy
climate action tracker the state of the climate crisis in 2020	climate
kristen bell giant ant why is the world warming up	ant
kristen bell giant ant where does all the carbon we release go	ant
kristen bell giant ant why is 15 degrees such a big deal	ant
kristen bell giant ant what is netzero	ant_netzero
johan rockstrm 10 years to transform the future of humanity or destabilize the planet	johan
monica araya how cities are detoxing transportation	monica_araya_cities
greg stone saving the ocean one island at a time	greg_ocean
brian skerry the oceans glory and horror	brian
barbara block tagging tuna in the deep ocean	barbara_ocean
jim toomey learning from sherman the shark	jim_sherman
ben katchor comics of bygone new york	ben_york
scott mccloud the visual magic of comics	scott_mccloud
david macaulay an illustrated journey through rome	david_rome
frank gehry my days as a young rebel	frank_gehry
frank gehry a master architect asks now what	frank_gehry
reed kroloff a tour of modern architecture	reed_kroloff_architecture
moshe safdie building uniqueness	moshe
vishaan chakrabarti how we can design timeless cities for our collective future	chakrabarti_design_cities_future
mark raymond victims of the city	raymond
richard wilkinson how economic inequality harms societies	richard_wilkinson
jim yong kim doesnt everyone deserve a chance at a good life	jim_kim
dave isay everyone around you has a story the world needs to hear	dave_isay
jr my wish use art to turn the world inside out	art
becci manson retouching lives through photos	manson
alec soth and stacey baker this is what enduring love looks like	stacey_baker_love
latif nasser the amazing story of the man who gave us modern pain relief	latif_nasser
atul gawande how do we heal medicine	medicine
thomas goetz its time to redesign medical data	thomas
rishi manchanda what makes us get sick look upstream	rishi_manchanda
eric dishman health care should be a team sport	eric_dishman_health_care
robert fischell my wish three unusual medical inventions	robert
andres lozano parkinsons depression and the switch that might turn them off	depression
david anderson your brain is more than a bag of chemicals	david_anderson_brain
gero miesenboeck reengineering the brain	brain
henry markram a brain in a supercomputer	markram_brain
suzana herculanohouzel what is so special about the human brain	suzana_brain
antonio damasio the quest to understand consciousness	antonio_damasio_consciousness
allan jones a map of the brain	allan_jones_brain
vilayanur ramachandran the neurons that shaped civilization	vilayanur_ramachandran
oliver sacks what hallucination reveals about our minds	oliver
rebecca saxe how we read each others minds	saxe
molly crockett beware neurobunk	crockett
sarahjayne blakemore the mysterious workings of the adolescent brain	brain
alison gopnik what do babies think	alison
patricia kuhl the linguistic genius of babies	patricia_kuhl
ajit narayanan a word game to communicate in any language	narayanan_language
shah rukh khan thoughts on humanity fame and love	rukh_khan_humanity_love
his holiness pope francis why the only future worth building includes everyone	pope_francis_future
his holiness pope francis our moral imperative to act on climate change and 3 steps we can take	pope_francis_act_climate_change
prince william this decade calls for earthshots to repair our planet	william
yvonne akisawyerr the city planting a million trees in two years	yvonne_trees
david lammy climate justice cant happen without racial justice	david_justice_climate
rose m mutiso the energy africa needs to develop and fight climate change	africa_energy_climate_change
rebecca henderson to save the climate we have to reimagine capitalism	henderson_climate_capitalism
lisa jackson and liz ogbu apples promise to be carbon neutral by 2030	lisa_jackson
dave clark and kara hurst amazons climate pledge to be netzero by 2040	dave_clark_kara_hurst_netzero_climate
christiana figueres the case for stubborn optimism on climate	christiana_climate
tom rivettcarnac how to shift your mindset and choose your future	tom
colette pichon battle climate change will displace millions heres how we prepare	pichon_climate_change
kelsey leonard why lakes and rivers should have the same rights as humans	rivers
latoya ruby frazier a creative solution for the water crisis in flint michigan	latoya_ruby_michigan_water
jon lowenstein family hope and resilience on the migrant trail	jon
melanie nezer the fundamental right to seek asylum	melanie_nezer
benedetta berti and evelien borgman what does it mean to be a refugee	evelien
denice frohman accents	frohman
mia nacamulli the benefits of a bilingual brain	mia_nacamulli_brain
derek abbott should you trust unanimous decisions	abbott
peggy andover the difference between classical and operant conditioning	andover
joelle rabow maletis the psychology of posttraumatic stress disorder	joelle_maletis_psychology
rebecca brachman could a drug prevent depression and ptsd	ptsd_depression
sebastian junger our lonely society makes it hard to come home from war	junger_lonely_war
jeanpaul mari the chilling aftershock of a brush with death	jeanpaul_mari_death
peter van uhm why i chose a gun	peter_van_uhm
julia bacha pay attention to nonviolence	bacha
julia bacha how women wage conflict without violence	bacha_women
srdja popovic how to topple a dictator	srdja
wael ghonim inside the egyptian revolution	wael_egyptian
wadah khanfar a historic moment in the arab world	wadah_arab
maajid nawaz a global culture to fight extremism	global_culture
jason mccue terrorism is a failed brand	terrorism
loretta napoleoni the intricate economics of terrorism	economics_terrorism
ian goldin navigating our global future	ian_global_future
paul gilding the earth is full	paul
peter diamandis abundance is our future	peter
tucker hiatt how fast are you moving right now	hiatt
marjee chmiel and trevor owens is there a center of the universe	chmiel_universe
dennis wildfogel what is the universe made of	wildfogel_universe
dennis wildfogel how big is infinity	wildfogel
natalya st clair the unexpected math behind van goghs starry night	st_clair_van_math
hayley levitt who decides what art means	art
netta schramm why dont perpetual motion machines ever work	netta_schramm
brooke buddemeier and jessica s wieder can you survive nuclear fallout	brooke_jessica_nuclear
margaret bourdeaux why civilians suffer more once a war is over	margaret_bourdeaux_war
aala elkhani what its like to be a parent in a war zone	aala_elkhani_war
anders fjellberg two nameless bodies washed up on the beach here are their stories	fjellberg
melissa fleming lets help refugees thrive not just survive	melissa_refugees
melissa fleming a boat carrying 500 refugees sunk at sea the story of two survivors	melissa
luma mufleh dont feel sorry for refugees believe in them	luma_refugees
david miliband the refugee crisis is a test of our character	david
anthony d romero this is what democracy looks like	anthony_romero_democracy
laura galante how and why russia hacked the us election	galante_russia
james lyne everyday cybercrime and what you can do about it	james_lyne
keren elazari hackers the internets immune system	keren_elazari_immune
tamas kocsis the case for a decentralized internet	internet
yasmin green how technology can fight extremism and online harassment	green_technology
erin marie saltman how young people join violent extremist groups and how to stop them	marie
trita parsi iran and israel peace is possible	iran_israel
maz jobrani did you hear the one about the iranianamerican	jobrani_iranianamerican
jamil abuwardeh the axis of evil middle east comedy tour	jamil_abuwardeh_east_comedy
shereen el feki pop culture in the arab world	el_feki_arab_culture
maz jobrani a saudi an indian and an iranian walk into a qatari bar	jobrani_saudi_qatari
hannah gadsby three ideas three contradictions or not	hannah
lidia yuknavitch the beauty of being a misfit	lidia_beauty
joshua prager wisdom from great writers on every year of life	joshua_prager
joshua prager in search of the man who broke my neck	joshua_prager
hyeonseo lee my escape from north korea	lee_korea
sophal ear escaping the khmer rouge	khmer
cameron paterson the infamous and ingenious ho chi minh trail	ho_chi
fiona radford from enslavement to rebel gladiator the life of spartacus	fiona_radford_enslavement
einav zamir dembin did ancient troy really exist	dembin_ancient
peta greenfield alex gendler history vs augustus	alex_augustus_history
eric liu how to understand power	eric_liu
eric liu how to revive your belief in democracy	eric_liu_democracy
eric liu theres no such thing as not voting	eric_liu
beth noveck demand a more opensource government	beth_government
jennifer pahlka coding a better government	pahlka_government
catherine bracy why good hackers make good citizens	catherine
naomi klein addicted to risk	klein
edward burtynsky photographing the landscape of oil	edward
toni griffin a new vision for rebuilding detroit	toni_detroit
eric sanderson new york before the city	eric_york
bjarke ingels floating cities the lego house and other architectural forms of the future	cities
kotchakorn voraakhom how to transform sinking cities into landscapes that fight floods	cities
katharine hayhoe the most important thing you can do to fight climate change about it talk	katharine_hayhoe_climate_change
tim kruger can we stop climate change by removing co2 from the air	tim_kruger_climate_change
kate marvel can clouds buy us more time to solve climate change	climate_change
camille seaman photos from a storm chaser	seaman
joanne chory how supercharged plants could slow climate change	joanne_plants_climate_change
fred krupp lets launch a satellite to track a threatening greenhouse gas	krupp
natalie panek lets clean up the space junk orbiting earth	natalie_panek
dan berkenstock the world is one big dataset now how to photograph it	dan
joel levine why we need to go back to mars	joel_mars
peter diamandis our next giant leap	peter
peter diamandis stephen hawkings zero g flight	peter_stephen_flight
jason pontin can technology solve our big problems	pontin_technology
james green 3 moons and a planet that could have alien life	james_green_alien
tabetha boyajian the most mysterious star in the universe	star_universe
phil plait the secret to scientific discoveries making mistakes	phil_plait
sarah t stewart where did the moon come from a new theory	sarah_stewart_moon
david baron you owe it to yourself to experience a total solar eclipse	david_solar
andrea ghez the hunt for a supermassive black hole	andrea_ghez_hunt
miho janvier lessons from a solar storm chaser	solar
nagin cox what time is it on mars	mars
dave brain what a planet needs to sustain life	dave
marjan van aubel the beautiful future of solar power	marjan_van_aubel_future_solar
hannah brckstmmer a printable flexible organic solar cell	hannah_brckstmmer_solar
amar inamdar the thrilling potential for offgrid solar energy	amar_potential_energy
al gore the case for optimism on climate change	al_gore_climate_change
vicki arroyo lets prepare for our new climate	vicki_climate
larry brilliant the case for optimism	larry
david titley how the military fights climate change	david_military_climate_change
kristin poinar whats hidden under the greenland ice sheet	kristin_poinar_greenland
zaria forman drawings that show the beauty and fragility of earth	beauty
laura robinson the secrets i find on the mysterious ocean floor	ocean
david gruber glowinthedark sharks and other stunning sea creatures	david
carl safina what are animals thinking and feeling	carl_safina_animals
steven wise chimps have feelings and thoughts they should also have rights	steven
jane goodall what separates us from chimpanzees	goodall
zeresenay alemseged the search for humanitys roots	zeresenay
svante pbo dna clues to our inner neanderthal	dna
louise leakey a dig for humanitys origins	leakey
juliet brophy how a new species of ancestors is changing our theory of human evolution	juliet_human_evolution
prosanta chakrabarty four billion years of evolution in six minutes	prosanta_evolution
prosanta chakrabarty clues to prehistoric times found in blind cavefish	prosanta
kenneth lacovara hunting for dinosaurs showed me our place in the universe	kenneth_lacovara_dinosaurs_universe
paul sereno digging up dinosaurs	paul_dinosaurs
nizar ibrahim how we unearthed the spinosaurus	nizar
jack horner where are the baby dinosaurs	jack_horner_dinosaurs
jack horner building a dinosaur from a chicken	jack_horner
jill heinerth the mysterious world of underwater caves	jill
genevieve von petzinger why are these 32 symbols found in ancient caves all over europe	von_europe_ancient
elizabeth lindsey curating humanitys heritage	elizabeth
roz savage why im rowing across the pacific	pacific
john delaney wiring an interactive ocean	john_ocean
kristina gjerde making law on the high seas	kristina_law
paul snelgrove a census of the ocean	paul_snelgrove_ocean
enric sala lets turn the high seas into the worlds largest nature reserve	sala_nature
triona mcgrath how pollution is changing the oceans chemistry	triona_pollution_chemistry
jason decaires taylor an underwater art museum teeming with life	taylor_art
dustin yellin a journey through the mind of an artist	dustin_yellin
reuben margolin sculpting waves in wood and time	margolin
tom shannon antigravity sculpture	tom_shannon
brian jones what on earth is spin	brian_jones
lina marieth hoyos what is the coldest thing in the world	marieth_hoyos
bill gross a solar energy system that tracks the sun	gross_solar_energy
bill ford a future beyond traffic gridlock	ford
enrique pealosa why buses represent democracy in action	pealosa
lisa gansky the future of business is the mesh	lisa_business
rachel botsman the currency of the new economy is trust	rachel_trust
onora oneill what we dont understand about trust	onora_trust
rory stewart why democracy matters	stewart_democracy
david cameron the next age of government	david
heather brooke my battle to expose government corruption	brooke_corruption
paul lewis how mobile phones helped solve two murders	paul_lewis
eli pariser beware online filter bubbles	eli
tim bernerslee a magna carta for the web	tim_bernerslee_magna
tim bernerslee the next web	tim_bernerslee
michael green the global goals weve made progress on and the ones we havent	michael_green_global_goals
anna rosling rnnlund see how the rest of the world lives organized by income	anna
hans and ola rosling how not to be ignorant about the world	ola
barry schwartz the way we think about work is broken	barry_work
michael kimmel why gender equality is good for everyone men included	michael_gender_equality
dan ariely how equal do we want the world to be youd be surprised	dan
thomas piketty new thoughts on capital in the twentyfirst century	thomas
nick hanauer beware fellow plutocrats the pitchforks are coming	nick_hanauer
paul piff does money make you mean	paul
michael norton how to buy happiness	michael_norton_happiness
dave meslin the antidote to apathy	dave
j marshall shepherd 3 kinds of bias that shape your worldview	shepherd
stuart firestein the pursuit of ignorance	firestein
jonathan drori what we think we know	jonathan
alan kay a powerful idea about ideas	alan_kay
arthur benjamin the magic of fibonacci numbers	arthur_benjamin_magic
adam spencer why i fell in love with monster prime numbers	adam_prime
conrad wolfram teaching kids real math with computers	conrad_math_computers
stephen wolfram computing a theory of all knowledge	stephen_theory
lee smolin science and democracy	lee_smolin_science
jim holt why does the universe exist	jim_holt
david chalmers how do you explain consciousness	david_consciousness
john searle our shared condition consciousness	john_consciousness
anil seth your brain hallucinates your conscious reality	seth_brain
uri hasson this is your brain on communication	uri_hasson_brain_communication
chris anderson teds secret to great public speaking	chris_anderson_public_speaking
haley van dyck how a startup in the white house is changing business as usual	van
clay shirky how the internet will one day transform government	internet_government
don tapscott four principles for the open world	don
sherry turkle connected but alone	sherry
amber case we are all cyborgs now	amber
david hanson robots that show emotion	david_robots
caleb chung playtime with pleo your robotic dinosaur friend	chung_pleo
seth priebatsch the game layer on top of the world	seth
jesse schell when games invade real life	jesse
jane mcgonigal gaming can make a better world	gaming
david blaine how i held my breath for 17 minutes	david
lennart green closeup card magic with a twist	green_magic
apollo robbins the art of misdirection	apollo
black my journey to yoyo mastery	yoyo_mastery
john bohannon dance vs powerpoint a modest proposal	john_powerpoint_dance
sunni brown doodlers unite	sunni_brown
stefan sagmeister the power of time off	stefan
stefan sagmeister 7 rules for making more happiness	stefan_happiness
stanley mcchrystal the military case for sharing knowledge	stanley_military
stanley mcchrystal listen learn then lead	stanley
david logan tribal leadership	david_leadership
seth godin the tribes we lead	seth
tony wysscoray how young blood might help reverse aging yes really	tony_wysscoray_aging
beth malone how my dads dementia changed my idea of death and life	beth_death
lucy kalanithi what makes life worth living in the face of death	lucy_death
amy green a video game to cope with grief	green
alyssa monks how loss helped one artist find beauty in imperfection	alyssa_beauty
melissa walker art can heal ptsds invisible wounds	melissa_ptsds_art
wes moore how to to veterans about war talk	moore_war
colin powell kids need structure	colin_powell_kids
sebastian junger why veterans miss war	junger_war
keith nolan deaf in the military	keith_military
stacey kramer the best gift i ever survived	stacey
randy pausch really achieving your childhood dreams	randy_pausch
louie schwartzberg nature beauty gratitude	schwartzberg
hannah brencher love letters to strangers	hannah
mena trott meet the founder of the blog revolution	trott
jonny sun you are not alone in your loneliness	jonny
anne lamott 12 truths i learned from life and writing	anne_lamott_writing
david brooks the social animal	david_brooks
tony robbins why we do what we do	tony
christine porath why being respectful to your coworkers is good for business	business
jason shen looking for a job highlight your ability not your experience	shen
dan ariely what makes us feel good about our work	dan_work
dan ariely beware conflicts of interest	dan
iain hutchison saving faces a facial surgeons craft	hutchison
anthony atala growing new organs	anthony_atala
anthony atala printing a human kidney	anthony_atala
andras forgacs leather and meat without killing animals	animals
susan solomon the promise of research with stem cells	susan_solomon_research
nina tandon could tissue engineering mean personalized medicine	nina_engineering_medicine
kary mullis a nextgen cure for killer infections	kary_mullis
tal danino programming bacteria to detect cancer and maybe treat it	tal_bacteria_cancer
mina bissell experiments that point to a new understanding of cancer	cancer
elizabeth murchison fighting a contagious cancer	elizabeth_murchison_cancer
jimmy lin a simple new blood test that can catch cancer early	lin_cancer
sangeeta bhatia this tiny particle could roam your body to find tumors	bhatia
paula hammond a new superweapon in the fight against cancer	paula_superweapon_cancer
hasini jayatilaka how cancer cells communicate and how we can slow them down	jayatilaka_cancer
debra jarvis yes i survived cancer but that doesnt define me	jarvis_cancer
andrew solomon how the worst moments in our lives make us who we are	andrew_solomon
andrew solomon love no matter what	andrew_solomon_love
rufus griscom alisa volkman lets parenting taboos talk	rufus_griscom
bruce feiler agile programming for your family	bruce_family
bruce feiler the council of dads	bruce_council
aimee mullins the opportunity of adversity	aimee
aimee mullins changing my legs and my mindset	aimee
aimee mullins my 12 pairs of legs	aimee
christine sun kim the enchanting music of sign language	kim_music_language
suzanne talhouk dont kill your language	suzanne_language
patricia ryan dont insist on english	patricia
jay walker the worlds english mania	jay_mania
john mcwhorter 4 reasons to learn a new language	john_language
john mcwhorter txtng is killing language jk	john_language
anne curzan what makes a word real	anne
jeanbaptiste michel erez lieberman aiden what we learned from 5 million books	michel_lieberman
thomas p campbell weaving narratives in museum galleries	thomas
ravin agrawal 10 young indian artists to watch	ravin
shea hembrey how i became 100 artists	shea_hembrey
tom shannon john hockenberry the painter and the pendulum	tom_shannon_john
alison jackson an unusual glimpse at celebrity	alison_jackson
jonathan klein photos that changed the world	jonathan_klein
erik johansson impossible photography	erik_johansson_photography
mary norris the nitpicking glory of the new yorkers comma queen	mary_norris_queen
emma bryce how to use a semicolon	bryce
matthew winkler what makes a hero	matthew
iseult gillespie the irish myth of the giants causeway	gillespie
iseult gillespie the myth of jason and the argonauts	gillespie
alex gendler the myth of hercules	alex
iseult gillespie the myth of pandoras box	gillespie
alex gendler the myth of sisyphus	alex
alan lupack is there any truth to the king arthur legends	alan_arthur
anne f broadbridge a day in the life of a mongolian queen	anne_mongolian_queen
elizabeth cox a day in the life of an ancient egyptian doctor	elizabeth_egyptian_ancient
christina warinner tracking ancient diseases using plaque	christina_warinner_ancient
harvey fineberg are we ready for neoevolution	fineberg
alex gendler myths and misconceptions about evolution	alex_evolution
jennifer kahn gene editing can now change an entire species forever	kahn
juan enriquez we can reprogram life how to do it wisely	juan_reprogram
yuval noah harari what explains the rise of humans	noah_harari
frans de waal moral behavior in animals	waal_animals
barbara j king grief and love in the animal kingdom	barbara_love
robyn j crook how do animals experience pain	crook_animals
joao pedro de magalhaes why do animals have such different lifespans	joao_animals
alejandro snchez alvarado to solve old problems study new species	alvarado
stewart brand and chris anderson mammoths resurrected geoengineering and other thoughts from a futurist	stewart_chris_anderson
stewart brand the dawn of deextinction are you ready	stewart_deextinction
hendrik poinar bring back the woolly mammoth	hendrik_poinar
jennifer doudna how crispr lets us edit our dna	dna_crispr
patience mthunzi could we cure hiv with lasers	hiv
julian burschka could a breathalyzer detect cancer	julian_burschka_cancer
shohini ghose the genius of marie curie	marie_curie
matt anticole is radiation dangerous	matt
steven zheng how does anesthesia work	steven
helen m farrell the truth about electroconvulsive therapy ect	helen_farrell
shai marcu the benefits of a good nights sleep	shai_sleep
claudia aguirre what would happen if you didnt sleep	claudia_sleep
dan kwartler what causes insomnia	dan
karen d davis how does your brain respond to pain	karen_davis_brain
george zaidan how do pain relievers work	george_zaidan
krishna sudhir how do cigarettes affect the body	body
nicole avena how sugar affects the brain	nicole_avena_brain
robert lustig sugar hiding in plain sight	robert
richard j wood how do carbohydrates impact your health	richard_health
george zaidan what is fat	george_zaidan
rose eveleth the science of spiciness	eveleth_science
k erica dodge gyotaku the ancient japanese art of printing fish	erica_dodge_gyotaku_japanese_art_fish
jackie savitz save the oceans feed the world	jackie_savitz
stephen palumbi hidden toxins in the fish we eat	stephen_palumbi_fish
peter tyack the intriguing sound of marine mammals	peter_marine
denise herzing could we speak the language of dolphins	language
rose george inside the secret shipping industry	george
paul greenberg the four fish were overeating and what to eat instead	paul_greenberg_fish
mike velings the case for fish farming	mike_fish
lauren sallan how to win at evolution and survive a mass extinction	lauren
latif nasser you have no idea where camels really come from	latif_nasser
patrcia medici the coolest animal you know nothing about and how we can save it	patrcia_coolest
tasso azevedo hopeful lessons from the battle to save rainforests	tasso_azevedo
james hansen why i must speak out about climate change	james_climate_change
gavin schmidt the emergent patterns of climate change	gavin_schmidt_climate_change
kelly wanser emergency medicine for our climate fever	kelly_fever_climate
jennifer wilcox a new way to remove co2 from the atmosphere	wilcox
bina venkataraman the power to think ahead in a reckless age	venkataraman
ari wallach 3 ways to plan for the very long term	ari
yuval noah harari nationalism vs globalism the new political divide	noah_harari
david autor will automation take away all our jobs	david
tim leberecht 4 ways to build a human company in the age of machines	tim_leberecht
tim leberecht 3 ways to usefully lose control of your brand	tim_leberecht
johanna blakley social media and the end of gender	johanna_social_media
sally kohn dont like clickbait dont click	sally_kohn
sally kohn lets try emotional correctness	sally_kohn
elizabeth lesser take the other to lunch	elizabeth
aj jacobs my year of living biblically	jacobs
james burchfield playing invisible turntables	james
kenichi ebina my magic moves	kenichi_ebina
michael moschen juggling as art and science	michael
mallika sarabhai dance to change the world	sarabhai_dance_change
naturally 7 a fullband beatbox	beatbox
mellody hobson color blind or color brave	hobson
freeman hrabowski 4 pillars of college success in science	freeman_hrabowski_science
tyler dewitt hey science teachers make it fun	science
beau lotto amy otoole science is for everyone kids included	science_kids
thomas suarez a 12yearold app developer	thomas_suarez
ali carrchellman gaming to reengage boys in learning	ali_carrchellman_gaming
reshma saujani teach girls bravery not perfection	saujani
margaret heffernan forget the pecking order at work	margaret_heffernan_work
margaret heffernan dare to disagree	margaret_heffernan
margaret heffernan the dangers of willful blindness	margaret_heffernan
julian assange why the world needs wikileaks	julian
ethan zuckerman listening to global voices	ethan_global
charmian gooch my wish to launch a new era of openness in business	gooch_business
charmian gooch meet global corruptions hidden players	gooch_global
robert palmer the panama papers exposed a huge global problem whats next	robert_panama_global
gerard ryle how the panama papers journalists broke the biggest leak in history	panama
edward snowden heres how we take back the internet	edward_internet
mikko hypponen how the nsa betrayed the worlds trust time to act	nsa_act
james surowiecki the power and the danger of online crowds	james_surowiecki
deborah gordon inside the ant colony	deborah_gordon_ant
deborah gordon what ants teach us about the brain cancer and the internet	deborah_gordon_cancer_internet
michael dickinson how a fly flies	michael
sara lewis the loves and lies of fireflies	sara_lewis
carin bondar the birds and the bees are just the beginning	carin
keith bellows the camels hump	keith_hump
jonathan wilker what sticky sea creatures can teach us about making glue	jonathan
karen lloyd this deepsea mystery is changing our understanding of life	karen_lloyd
anne madden meet the microscopic life in your home and on your face	anne
ani liu smelfies and other experiments in synthetic biology	ani_liu
sean follmer shapeshifting tech will change work as we know it	sean
fabian hemmert the shapeshifting future of the mobile phone	fabian
john underkoffler pointing to the future of ui	john
jinha lee reach into the computer and grab a pixel	lee_pixel
paul rothemund playing with dna that selfassembles	paul_dna
drew berry animations of unseeable biology	biology
david r liu can we cure genetic diseases by rewriting dna	david_liu_dna
luhan yang how to create a world where no one dies waiting for a transplant	yang
ellen jorgensen what you need to know about crispr	jorgensen_crispr
sebastian kraves the era of personal dna testing is here	dna
gabe barciacolombo my dna vending machine	gabe_dna
gabriel barciacolombo capturing memories in video art	gabriel_art
frank warren half a million secrets	frank_warren
jd schramm break the silence for suicide attempt survivors	jd_schramm_suicide
kevin briggs the bridge between suicide and life	kevin_bridge_suicide
steven strogatz the science of sync	steven_strogatz_science
ian firth bridges should be beautiful	ian
justin davidson why glass towers are bad for city life and what we need instead	justin
tom hulme what can we learn from shortcuts	tom_hulme
theaster gates how to revive a neighborhood with imagination beauty and art	art
amanda burden how public spaces make cities work	amanda_cities
kent larson brilliant designs to fit more people in every city	kent_fit
geoffrey west the surprising math of cities and corporations	geoffrey_west_math_cities
lord nicholas stern the state of the climate and what we might do about it	lord_climate
alex steffen the shareable future of cities	alex_steffen_cities
robert muggah the biggest risks facing cities and some solutions	robert_cities
robert muggah how to protect fastgrowing cities from failing	robert_cities
gary slutkin lets treat violence like a contagious disease	gary_violence_disease
eric berlow and sean gourley mapping ideas worth spreading	eric_sean_gourley
sean gourley the mathematics of war	sean_gourley_war
eric berlow simplifying complexity	eric
george whitesides toward a science of simplicity	george
david pogue simplicity sells	david_pogue
david pogue 10 top timesaving tech tips	david_pogue
david pogue cool tricks your phone can do	david_pogue
jamais cascio tools for a better world	jamais_cascio
paul conneally how mobile phones power disaster relief	paul_disaster
peter haas when bad engineering makes a natural disaster even worse	peter_natural_disaster
caitria morgan oneill how to step up in the face of disaster	caitria_morgan_disaster
erez yoeli how to motivate people to do good for others	yoeli
abigail marsh why some people are more altruistic than others	abigail_marsh
matthieu ricard how to let altruism be your guide	matthieu
bill and melinda gates why giving away our wealth has been the most satisfying thing weve done	melinda
bill gates mosquitos malaria and education	malaria_education
adam davidson what we learned from teetering on the fiscal cliff	adam_cliff
jonathan haidt how common threats can make common political ground	jonathan
jonathan haidt religion evolution and the ecstasy of selftranscendence	jonathan_religion_evolution
jd vance americas forgotten working class	jd
mia birdsong the story we tell about poverty isnt true	mia_poverty
esther duflo social experiments to fight poverty	poverty
peter singer the why and how of effective altruism	peter
jacqueline novogratz inspiring a life of immersion	jacqueline_novogratz
musimbi kanyoro to solve the worlds biggest problems invest in women and girls	kanyoro_women
iseult gillespie why should you read kafka on the shore	gillespie
jacqueline woodson what reading slowly taught me about writing	jacqueline_woodson_writing
nnedi okorafor scifi stories that imagine a future africa	africa_future
emtithal mahmoud a young poet tells the story of darfur	emtithal_mahmoud_darfur
chinaka hodge what will you tell your daughters about 2016	chinaka_hodge
kimberl crenshaw the urgency of intersectionality	kimberl
nina jablonski skin color is an illusion	nina_jablonski
angela koine flynn the science of skin color	angela_koine_flynn_science
anglica dass the beauty of human skin in every color	anglica_beauty
latoya ruby frazier a visual history of inequality in industrial america	latoya_ruby_america
shereen el feki a littletold tale of sex and sensuality	el_feki_tale_sex
shereen el feki hiv how to fight an epidemic of bad laws	el_feki_hiv
edsel salvaa the dangerous evolution of hiv	edsel_salvaa_hiv
arik hartmann our treatment of hiv has advanced why hasnt the stigma changed	arik_hartmann_hiv
boghuma kabisen titanji ethical riddles in hiv research	boghuma_kabisen_hiv
frederick balagadde biolab on a microchip	frederick_balagadde_biolab
george whitesides a lab the size of a postage stamp	george
william kamkwamba how i harnessed the wind	william
george dyson the birth of the computer	george_dyson
john grahamcumming the greatest machine that never was	john
neil macgregor 2600 years of history in one object	neil_macgregor_history
paddy ashdown the global power shift	global
madeleine albright on being a woman and a diplomat	madeleine_albright
nadia alsakkaf see yemen through my eyes	nadia_alsakkaf_yemen
manal alsharif a saudi woman who dared to drive	saudi
dalia mogahed the attitudes that sparked arab spring	arab
cecile richards the political progress women have made and whats next	women
tracee ellis ross a womans fury holds lifetimes of wisdom	ellis_ross
justin baldoni why im done trying to be man enough	justin
sandi toksvig a political party for womens equality	equality
billie jean king this tennis icon paved the way for women in sports	jean_women_sports
may elkhalil making peace is a marathon	elkhalil
john hunter teaching with the world peace game	john
tom chatfield 7 ways games reward the brain	tom
daphne bavelier your brain on video games	daphne_brain
brenda romero gaming for understanding	brenda_romero_gaming
steve keil a manifesto for play for bulgaria and beyond	steve_keil_bulgaria
yana buhrer tavanier how to recover from activism burnout	yana_activism
rana abdelhamid 3 lessons on starting a movement from a selfdefense trailblazer	rana_abdelhamid
t morgan dixon and vanessa garrison the most powerful woman youve never heard of	morgan_dixon
t morgan dixon and vanessa garrison the trauma of systematic racism is killing black women a first step toward change	morgan_dixon_women_change
david r williams how racism makes us sick	david_williams
dorothy roberts the problem with racebased medicine	medicine
alyson mcgregor why medicine often has dangerous side effects for women	medicine_women
francis collins we need better drugs now	francis_drugs
geraldine hamilton body parts on a chip	hamilton
nina tandon caring for engineered tissue	nina
angela belcher using nature to grow batteries	angela_belcher_nature
floyd e romesberg the radical possibilities of manmade dna	floyd_dna
dan gibson how to build synthetic dna and send it across the internet	dan_dna
riccardo sabatini how to read the genome and build a human being	sabatini
christoph adami finding life we cant imagine	christoph_adami
lee cronin making matter come alive	lee
martin hanczyc the line between life and notlife	martin_hanczyc
luca turin the science of scent	luca_turin_science
jakob magolan a crash course in organic chemistry	jakob_magolan_chemistry
carolyn bertozzi what the sugar coating on your cells is trying to tell you	bertozzi
laura indolfi good news in the fight against pancreatic cancer	cancer
william li can we eat to starve cancer	william_li_cancer
joshua smith new nanotech to detect cancer early	joshua_smith_nanotech_cancer
adam de la zerda we can start winning the war against cancer	adam_zerda_cancer
mary lou jepsen could future devices read images from our brains	mary_lou_jepsen
nancy kanwisher a neural portrait of the human mind	kanwisher_neural
bradley voytek and tim verstynen diagnosing a zombie brain and body part one	bradley_voytek_tim_zombie
elizabeth cox what causes hallucinations	elizabeth
michael s a graziano what is consciousness	michael_consciousness
elizabeth cox the surprising link between stress and memory	elizabeth_memory
madhumita murgia how stress affects your brain	madhumita_murgia_brain
helen m farrell what is depression	helen_farrell_depression
michael molina what is dj vu what is dj vu	michael_molina
nikki webber allen dont suffer from your depression in silence	nikki_allen_depression
sangu delle theres no shame in taking care of your mental health	sangu_delle_care_mental_health
mariano sigman your words may predict your future mental health	mariano_future_mental_health
thomas insel toward a new understanding of mental illness	thomas_mental
aditi shankardass a second opinion on developmental disorders	aditi
jane chen a warm embrace that saves lives	chen
annie murphy paul what we learn before were born	annie_paul
dan buettner how to live to be 100	dan
peter attia is the obesity crisis hiding a bigger problem	peter_attia
anders ynnerman visualizing the medical data explosion	ynnerman_data
kenneth cukier big data is better data	kenneth_data
garry kasparov dont fear intelligent machines work with them	garry_kasparov
stuart russell 3 principles for creating safer ai	russell_ai
sam harris can we build ai without losing control over it	sam_harris_ai
nick bostrom what happens when our computers get smarter than we are	nick_bostrom
ken jennings watson jeopardy and me the obsolete knowitall	ken_watson
ray kurzweil get ready for hybrid thinking	kurzweil
erik brynjolfsson the key to growth race with the machines	erik_brynjolfsson
steven levitt the freakonomics of crack dealing	steven
michael tubbs the political power of being a good neighbor	michael
steven petrow 3 ways to practice civility	steven
niro sivanathan the counterintuitive way to be more persuasive	niro_sivanathan
neal katyal how to win an argument at the us supreme court or anywhere	supreme
michael sandel the lost art of democratic debate	michael_sandel
philip k howard four ways to fix a broken legal system	philip_howard
vivek maru how to put the power of law in peoples hands	vivek_law
victoria pratt how judges can show respect	victoria_pratt
raj jayadev communitypowered criminal justice reform	justice
tracie keesee how police and the public can create safer neighborhoods together	tracie_keesee
melvin russell i love being a police officer but we need reform	melvin_russell
ivan krastev can democracy exist without trust	ivan_democracy
yasheng huang does democracy stifle economic growth	yasheng_huang_stifle_democracy
martin jacques understanding the rise of china	martin_jacques_china
joseph nye global power shifts	joseph_global
tim jackson an economic reality check	tim_jackson
chrystia freeland the rise of the new global superrich	superrich_global
james b glattfelder who controls the world	james
tanya menon the secret to great opportunities the person you havent met yet	tanya
susan pinker the secret to living longer may be your social life	susan
robert waldinger what makes a good life lessons from the longest study on happiness	robert_happiness
helen fisher technology hasnt changed love heres why	helen_fisher_technology_love
mandy len catron falling in love is the easy part	mandy_len_catron_love
mandy len catron a better way to about love talk	mandy_len_catron_love
skye c cleary why do we love a philosophical inquiry	love
dawn maslar the science of attraction	science
christian rudder inside okcupid the math of online dating	christian_math
priyanka jain how to make applying for jobs less painful	priyanka_jain
dan clay why you should bring your whole self to work	dan_work
nicaila matthews okome this is the side hustle revolution	nicaila_hustle
michael c bush this is what makes employees happy at work	michael_bush_work
matt mullenweg why working from home is good for business	matt_mullenweg_business
patty mccord 8 lessons on building a company people enjoy working for	patty_mccord
wendy de la rosa 3 psychological tricks to help you save money	rosa_money
amy nicole baker 7 common questions about workplace romance	nicole_baker
katie hood the difference between healthy and unhealthy love	love
susan david the gift and power of emotional courage	susan_david
susan robinson how i fail at being disabled	susan
isaac lidsky what reality are you creating for yourself	isaac_lidsky
daniel kish how i use sonar to navigate the world	sonar
david eagleman can we create new senses for humans	david_eagleman
jinsop lee design for all 5 senses	jinsop_lee_design
paola antonelli why i brought pacman to moma	antonelli_pacman
gabe zichermann how games make kids smarter	gabe_zichermann
peggy orenstein what young women believe about their own sexual pleasure	orenstein_women
sofia jawedwessel the lies we tell pregnant women	women
jessica ladd the reporting system that sexual assault survivors want	jessica_sexual
jimmy carter why i believe the mistreatment of women is the number one human rights abuse	mistreatment_women
meera vijayann find your voice against gender violence	meera_vijayann_gender_violence
chetna gala sinha how women in rural india turned courage into capital	india_women
kevin kelly how ai can bring on a second industrial revolution	kevin_kelly_ai_industrial
max tegmark how to get empowered not overpowered by ai	max_tegmark_ai
sebastian thrun and chris anderson what ai is and isnt	chris_anderson_ai
anab jain why we need to imagine different futures	anab_jain
margaret heffernan the human skills we need in an unpredictable world	margaret_heffernan
daniel susskind 3 myths about the future of work and why theyre not true	future_work
martin ford how well earn money in a future without jobs	martin_ford_future
courtney e martin the new american dream	courtney_martin_american
arthur brooks a conservatives plea lets work together	arthur_brooks
lawrence lessig the unstoppable walk to political reform	lessig
lawrence lessig we the people and the republic we must reclaim	lessig
christina greer does your vote count the electoral college explained	christina
jay van bavel do politics make us irrational	jay_van_politics
damon brown how to choose your news	brown
jeff leek and lucy mcgowan this one weird trick will help you spot clickbait	jeff_lucy_mcgowan
jeff leek and lucy mcgowan can you spot the problem with these headlines level 1	jeff_lucy_mcgowan
christina greer how one journalist risked her life to hold murderers accountable	christina
christina greer notes of a native son the world according to james baldwin	christina_james
janell hobson the breathtaking courage of harriet tubman	janell_hobson_harriet
anthony hazard the atlantic slave trade what too few textbooks told you	anthony_atlantic
paul rucker the symbols of systemic racism and how to take away their power	paul_rucker_systemic
paul rucker how my mom inspired my approach to the cello	paul_rucker
sanford biggers an artists unflinching look at racial violence	sanford
tarana burke me too is a movement not a moment	tarana_burke
ashley judd how online abuse of women has spiraled out of control	ashley_judd_women
monica lewinsky the price of shame	monica
theo ej wilson a black man goes undercover in the altright	undercover
joseph ravenell how barbershops can keep men healthy	joseph
mary bassett why your doctor should care about social justice	mary_bassett_justice_care_social
pardis sabeti how well fight the next deadly virus	sabeti
bill gates how we must respond to the coronavirus pandemic	coronavirus_pandemic
adam kucharski how can we control the coronavirus pandemic	adam_kucharski_coronavirus_pandemic
the interview adam kucharski on what should and shouldnt worry us about the coronavirus ted	adam_kucharski_coronavirus_ted
david heymann what we do and dont know about the coronavirus	david_heymann_coronavirus
johanna benesty what it takes to crush a pandemic	johanna_pandemic
heidi larson why rumors about vaccines spread and how to rebuild trust	vaccines
jerome kim the trials tribulations and timeline of a covid19 vaccine	jerome_kim
seth berkley the quest for the coronavirus vaccine	seth_coronavirus
seth berkley the troubling reason why vaccines are made too late if theyre made at all	seth_vaccines
seth berkley hiv and flu the vaccine strategy	seth_hiv_flu
mark kendall demo a needlefree vaccine patch thats safer and way cheaper	kendall_demo
adam grosser a mobile fridge for vaccines	adam_vaccines
kary mullis play experiment discover	kary_mullis
mel robbins how to stop screwing yourself over	mel
tim ferriss why you should define your fears instead of your goals	tim_goals
tim ferriss smash fear learn anything	tim_fear
elizabeth gilbert success failure and the drive to keep creating	elizabeth_gilbert_success
john wooden the difference between winning and succeeding	john
pico iyer what pingpong taught me about life	pingpong
shimon schocken what a bike ride can teach you	shimon
omar ahmad political change with pen and paper	omar_change
eric liu why ordinary people need to understand power	eric_liu
brett hennig what if we replaced politicians with randomly selected people	brett
zachariah mampilly how protest is redefining democracy around the world	protest_democracy
csar hidalgo a bold idea to replace politicians	csar_hidalgo
yuval noah harari why fascism is so tempting and how your data could power it	noah_harari
carole cadwalladr facebooks role in brexit and the threat to democracy	carole_cadwalladr_brexit_democracy
carole cadwalladr its not about privacy its about power	carole_cadwalladr
jorge ramos why journalists have an obligation to challenge power	ramos
stephanie busari how fake news does real harm	stephanie_busari
sisonke msimang if a story moves you act on it	msimang_act
olga yurkova inside the fight against russias fake news empire	olga_yurkova
ameera harouda why i put myself in danger to tell the stories of gaza	gaza
aziz abu sarah for more tolerance we need more tourism	aziz_abu_sarah
el seed street art with a message of hope and peace	el_street_art
cristina domenech poetry that frees the soul	cristina_poetry
stephen burt why people need poetry	stephen_poetry
james geary metaphorically speaking	james
rachelle garniez la vie en rose	rachelle
kaki king a musical escape into a world of light and color	kaki
kaki king playing pink noise on guitar	kaki_guitar
anika paulson how i found myself through music	music
jorge drexler poetry music and identity	poetry_music_identity
eduardo senz de cabezn math is forever	senz_math
harry baker a love poem for lonely prime numbers	harry_baker_poem_lonely_prime
dan meyer math class needs a makeover	dan_math
mohamad jebara this company pays kids to do their math homework	jebara_math
roger antonsen math is the hidden secret to understanding the world	roger_antonsen_math
jim simons the mathematician who cracked wall street	jim_wall_street
dan pallotta the way we think about charity is dead wrong	dan_pallotta
melinda gates what nonprofits can learn from cocacola	melinda
sasha dichter the generosity experiment	sasha
ashwini anburajan how cryptocurrency can help startups get investment capital	anburajan_cryptocurrency
bettina warburg how the blockchain will radically transform the economy	bettina_warburg_blockchain
don tapscott how the blockchain is changing money and business	don_blockchain_business
paul kemprobertson bitcoin sweat tide meet the future of branded currency	paul_kemprobertson
rory sutherland sweat the small stuff	sutherland
rory sutherland life lessons from an ad man	sutherland
benjamin wallace the price of happiness	benjamin_happiness
sam harris science can answer moral questions	sam_harris_science
richard dawkins militant atheism	richard_atheism
anjali kumar my failed mission to find god and what i found instead	kumar_god
casey gerald the gospel of doubt	gerald
casey gerald embrace your raw strange magic	gerald
luvvie ajayi jones get comfortable with being uncomfortable	jones
scott dinsmore how to find work you love	scott_work
maya penn meet a young entrepreneur cartoonist designer activist	maya_entrepreneur
cameron herold lets raise kids to be entrepreneurs	kids
shawn achor the happy secret to better work	work
jessica mccabe this is what its really like to live with adhd	jessica
mehdi ordikhaniseyedlar what happens in your brain when you pay attention	brain
jocelyne bloch the brain may be able to repair itself with help	jocelyne_bloch_brain
chuck murry can we regenerate heart muscle with stem cells	chuck_heart
todd scott an intergalactic guide to using a defibrillator	scott
ian dunbar dogfriendly dog training	ian_dunbar
anand varma the first 21 days of a bees life	anand_varma_bees
louie schwartzberg hidden miracles of the natural world	schwartzberg
gary greenberg the beautiful nano details of our world	gary_greenberg_nano
magnus larsson turning dunes into architecture	architecture
damian palin mining minerals from seawater	palin
jonathan drori every pollen grain has a story	jonathan
jonathan drori the beautiful tricks of flowers	jonathan
joshua harvey the evolution of the human eye	joshua_evolution_human
nathan s jacobs how optical illusions trick your brain	nathan_jacobs_brain
elizabeth cox is fire a solid a liquid or a gas	elizabeth
andrea m henle how crispr lets you edit dna	andrea_dna_crispr
jessica green and karen guillemin you are your microbes	jessica_green_karen
emma bryce how do your hormones work	bryce
norman spack how i help transgender teens become who they want to be	norman_transgender
geena rocero why i must come out	geena
emily quinn the way we think about biological sex is wrong	quinn_sex
karissa sanbonmatsu the biology of gender from dna to the brain	karissa_dna_biology_gender_brain
moshe szyf how early life experience is written into dna	moshe_szyf_dna
paul knoepfler the ethical dilemma of designer babies	paul
zubaida bai a simple birth kit for mothers in the developing world	zubaida
miriam zoila prez how racism harms pregnant women and what can help	miriam_prez_women
elizabeth howell how we can improve maternal healthcare before during and after pregnancy	elizabeth_healthcare_pregnancy
alexandra sacks a new way to think about the transition to motherhood	alexandra
jessica shortall the us needs paid family leave for the sake of its future	jessica_family_future
wajahat ali the case for having kids	ali_kids
tavi gevinson a teen just trying to figure it out	gevinson
emma marris nature is everywhere we just need to learn to see it	marris_nature
ron finley a guerrilla gardener in south central la	ron_finley
roger doiron my subversive garden plot	roger_doiron
steven pinker is the world getting better or worse a look at the numbers	steven
steven pinker human nature and the blank slate	steven
youngha kim be an artist right now	youngha_kim
phil hansen embrace the shake	phil
jay silver hack a banana make a keyboard	jay
ayah bdeir building blocks that blink beep and teach	bdeir
raghava kk whats your 200year plan	200year
marco tempest the magic of truth and lies and ipods	magic
golan levin art that looks back at you	levin_art
jeff hancock the future of lying	jeff
pamela meyer how to spot a liar	pamela
michael shermer the pattern behind selfdeception	michael
sheila nirenberg a prosthetic eye to treat blindness	sheila_nirenberg
charles limb your brain on improv	improv_brain
dessa can we choose to fall out of love	dessa_love
george blairwest 3 ways to build a happy marriage and avoid divorce	george
jenna mccarthy what you dont know about marriage	jenna
yoruba richen what the gay rights movement learned from the civil rights movement	yoruba
jenni chang and lisa dazols this is what lgbt life is like around the world	jenni_chang_lisa_lgbt
lindsay amer why kids need to learn about gender and sexuality	kids_gender
samy nour younes a short history of trans peoples long fight for equality	nour_history_equality
jackson bird how to and listen to transgender people talk	jackson_transgender
ivan coyote why we need genderneutral bathrooms	ivan
martine rothblatt my daughter my wife our robot and the quest for immortality	rothblatt
leland melvin an astronauts story of curiosity perspective and change	melvin
danielle wood 6 space technologies we can use to improve life on earth	space
xavier de kestelier adventures of an interplanetary architect	xavier
penelope boston there might just be life on mars	boston_mars
moriba jah the worlds first crowdsourced space traffic monitoring system	moriba_jah_space
andrew pontzen and tom whyntie the fundamentals of spacetime part 2	andrew_tom_spacetime
antony gormley sculpted space within and without	space
ganesh pai can you solve the passcode riddle	passcode
dennis shasha can you solve the stolen rubies riddle	shasha
tanya khovanova can you solve the leonardo da vinci riddle	tanya_khovanova_leonardo_vinci
dan finkel can you solve the rogue ai riddle	dan
gordon hamilton can you solve the mondrian squares riddle	gordon_hamilton
dan finkel can you solve the giant cat army riddle	dan
dan finkel can you solve the secret werewolf riddle	dan_werewolf
daniel finkel can you solve the alien probe riddle	alien
alex gendler can you solve the rebel supplies riddle	alex
rodney brooks robots will invade our lives	brooks_robots
cynthia breazeal the rise of personal robots	cynthia_robots
heather knight siliconbased comedy	comedy
kate darling why we have an emotional connection to robots	robots
leila takayama whats it like to be a robot	leila_takayama
robin murphy these robots come to the rescue after a disaster	robots_disaster
vijay kumar the future of flying robots	vijay_kumar_robots
raffaello dandrea the astounding athletic power of quadcopters	raffaello
raffaello dandrea meet the dazzling flying machines of the future	raffaello_future
sergei lupashin a flying camera on a leash	sergei
ken goldberg 4 lessons from robots about being human	ken_goldberg_robots
pter fankhauser meet rezero the dancing ballbot	ballbot
elizabeth streb my quest to defy gravity and fly	elizabeth_streb
alex honnold how i climbed a 3000foot vertical cliff without ropes	alex_cliff
hugh herr how well become cyborgs and extend human potential	human
hugh herr the new bionics that let us run climb and dance	bionics_dance
joshua w pate the mysterious science of pain	joshua_science
bethany rickwald and hayley levitt would you opt for a life with no pain	opt
eleanor nelsen marys room a philosophical thought experiment	nelsen_marys
puqun li zen kans unsolvable enigmas designed to break your brain	li
pazit cahlon and alex gendler what machiavellian really means	pazit_alex
alex gendler history vs napoleon bonaparte	alex_napoleon_bonaparte_history
j v maranto historys deadliest colors	maranto
stephen bax the worlds most mysterious book	stephen
elizabeth cox what really happened to the library of alexandria	elizabeth_library_alexandria
gregory heyworth how im discovering the secrets of ancient texts	ancient
michelle brown what is a butt tuba and why is it in medieval art	michelle_brown_tuba_art
iseult gillespie everything you need to know to read the canterbury tales	gillespie_canterbury
leonora neville the princess who rewrote history	leonora_neville_history
colin grant how our stories cross over	colin
georgette mulheir the tragedy of orphanages	georgette
claudia miner a new way to get every child ready for kindergarten	claudia_miner
olympia della flora creative ways to get kids to thrive in school	della_kids
anindya kundu the opportunity gap in us public education and how to close it	education
angela lee duckworth grit the power of passion and perseverance	angela_lee
liz kleinrock how to teach kids to about taboo topics talk	kleinrock_kids
danielle r moss how we can help the forgotten middle reach their full potential	potential
monique w morris why black girls are targeted for punishment at school and how to change that	change
kakenya ntaiya empower a girl transform a community	kakenya_ntaiya
elizabeth cox what is imposter syndrome and how can you combat it	elizabeth_syndrome
james zucker how do you know you exist	james
sharon terry science didnt understand my kids rare disease until i decided to study it	sharon_terry_science_kids_disease
jennifer brea what happens when you have a disease doctors cant diagnose	brea
keolu fox why genetic research must be more diverse	fox_research
richard resnick welcome to the genomic revolution	richard_genomic
paula johnson his and hers health care	paula_johnson_health
rebecca onie what if our health care system kept us healthy	health_care
erica frenkel the universal anesthesia machine	erica
tal golesworthy how i repaired my own heart	tal_heart
dave debronkart meet epatient dave	dave
niels van namen why the hospital of the future will be your own home	niels_van_namen_future
scott williams the hidden role informal caregivers play in health care	scott_williams_health_care
carolyn jones a tribute to nurses	jones
amanda bennett we need a heroic narrative for death	amanda_bennett_death
kelli swazey life that doesnt end with death	kelli_swazey_death
judy macdonald johnston prepare for a good end of life	judy_macdonald_johnston
peter saul lets about dying talk	peter_saul
jae rhim lee my mushroom burial suit	jae_lee
caitlin doughty a burial practice that nourishes the planet	caitlin
alison killing what happens when a city runs out of room for its dead	alison
alison killing theres a better way to die and architecture can help	alison_architecture
candy chang before i die i want to	chang
deanna van buren what a world without prisons could look like	van_buren
jarrell daniels what prosecutors and incarcerated people can learn from each other	jarrell
kim gorgens the surprising connection between brain injuries and crime	kim_brain_crime
eve abrams the human stories behind mass incarceration	abrams
ronald sullivan how i help free innocent people from prison	ronald_sullivan
robin steinberg what if we ended the injustice of bail	steinberg
dan reisel the neuroscience of restorative justice	dan_justice_neuroscience
anne milgram why smart statistics are the key to fighting crime	anne_crime
hannah fry is life really that complex	hannah_fry
kevin slavin how algorithms shape our world	kevin_slavin
cathy oneil the era of blind faith in big data must end	oneil_data
tricia wang the human insights missing from big data	tricia_wang_data
mallory freeman your companys data could help end world hunger	freeman_data
wanis kabbaj what a driverless world could look like	kabbaj_driverless
chris urmson how a driverless car sees the road	chris_urmson_driverless
dennis hong making a car for blind drivers	hong
andrew bastawrous get your next eye exam on a smartphone	andrew
thulasiraj ravilla how lowcost eye care can be worldclass	worldclass_care
stefan larsson what doctors can learn from each other	stefan
ellen t hoen pool medical patents save lives	hoen_medical
drew curtis how i beat a patent troll	troll
tania simoncelli should you be able to patent a human gene	simoncelli
edward tenner unintended consequences	edward
anil gupta indias hidden hotbeds of invention	invention
ra mashelkar breakthrough designs for ultralowcost products	mashelkar
sendhil mullainathan solving social problems with a nudge	sendhil_mullainathan
sanjay dastoor a skateboard with a boost	sanjay
andreas raptopoulos no roads theres a drone for that	andreas
john hockenberry we are all designers	john
steve ramirez and xu liu a mouse a laser beam a manipulated memory	steve_ramirez_liu_memory
joshua foer feats of memory anyone can do	joshua_foer_memory
sam kean what happens when you remove the hippocampus	sam_kean_hippocampus
dr natascha m santos debunking the myths of ocd	dr_natascha_ocd
rachel wurzman how isolation fuels opioid addiction	rachel_addiction
travis rieder the agony of opioid withdrawal and what doctors should tell patients about it	travis
chera kowalski the critical role librarians play in the opioid crisis	chera
michael botticelli addiction is a disease we should treat it like one	michael_botticelli_addiction_disease
johann hari everything you think you know about addiction is wrong	johann_hari_addiction
ethan nadelmann why we need to end the war on drugs	ethan_nadelmann_drugs
mark tyndall the harm reduction model of drug addiction treatment	addiction
russ altman what really happens when you mix medications	russ_altman
cline valry the dangers of mixing drugs	drugs
cline valry how does your body process medicine	body_medicine
daniel kraft the pharmacy of the future personalized pills 3d printed at home	future_3d
susan lim transplant cells not organs	susan_lim
nadine hachachharam how augmented reality could change the future of surgery	hachachharam_augmented_reality_surgery
peter weinstock lifelike simulations that make reallife surgery safer	peter_weinstock_surgery
nikolai begg a tool to fix one of the most dangerous moments in surgery	nikolai_surgery
yoav medan ultrasound surgery healing without cuts	medan_ultrasound
bill doyle treating cancer with electric fields	electric_cancer
matt beane how do we learn to work with intelligent machines	matt_work
kaifu lee how ai can save our humanity	kaifu_lee_ai
tom gruber how ai can enhance our memory work and social lives	tom_ai
maurice conti the incredible inventions of intuitive ai	conti_ai
anthony goldbloom the jobs well lose to machines and the ones we wont	anthony
chieko asakawa how new technology helps blind people explore the world	asakawa_technology
chris downey design with the blind in mind	chris_design
ron mccallum how technology allowed me to read	ron_technology
renata salecl our unhealthy obsession with choice	salecl
margaret gould stewart how the hyperlink changed everything	margaret_stewart
caroline weaver why the pencil is perfect	caroline_weaver
michael bierut the genius of the london tube map	michael_london
paola antonelli the 3000year history of the hoodie	antonelli_history
david rockwell the hidden ways stairs shape your life	david
isaac mizrahi how the button changed fashion	isaac_fashion
kyra gaunt how the jump rope got its rhythm	kyra
christopher bell bring on the female superheroes	christopher
mckenna pope want to be an activist start with your toys	pope_toys
franklin leonard how i accidentally changed the way movies get made	franklin
adong judith how i use art to bridge misunderstanding	adong_judith_bridge_art
nisha anand the radical act of choosing common ground	nisha_anand_act
matt cutts what happens when a silicon valley technologist works for the government	matt_valley_government
matt cutts try something new for 30 days	matt
derek sivers keep your goals to yourself	goals
antn garcaabril how prefab homes can transform affordable housing	prefab
charles hazlewood trusting the ensemble	hazlewood
mark applebaum the mad scientist of music	music
vishal vaid hypnotic south asian improv music	vaid_asian_improv_music
rbecca kleinberger why you dont like the sound of your own voice	kleinberger_sound
max little a test for parkinsons with a phone call	max
samuel cohen alzheimers is not normal aging and we can cure it	samuel_cohen_aging
julian burschka what your breath could reveal about your health	julian_burschka_health
catherine price why having fun is the secret to a healthier life	catherine
bevy smith how to discover your authentic self at any age	bevy_smith_self
candace parker how to break down barriers and not accept limits	parker
luvvie ajayi jones how to be a professional troublemaker	jones
john lewis and bryan stevenson the fight for civil rights and freedom	john_lewis_bryan
ibram x kendi the difference between being not racist and antiracist	kendi
dr phillip atiba goff rashad robinson dr bernice king anthony d romero the path to ending systemic racism in the us	dr_atiba_goff_bernice_anthony_romero_systemic
dr phillip atiba goff how we can make racism a solvable problem and improve policing	dr_atiba_goff
baratunde thurston how to deconstruct racism one headline at a time	thurston
alex gendler can you solve the prisoner hat riddle	alex
daniel finkel can you solve the vampire hunter riddle	vampire
alex gendler can you solve the giant iron riddle	alex
majd mashharawi how im making bricks out of ashes and rubble in gaza	gaza
anna heringer the warmth and wisdom of mud buildings	anna_heringer
stefan al will there ever be a milehigh skyscraper	stefan_al
david mackay a reality check on renewables	david_mackay
kirk sorensen thorium an alternative nuclear fuel	kirk_nuclear
michael shellenberger how fear of nuclear power is hurting the environment	michael_fear_nuclear_environment
stewart brand mark z jacobson debate does the world need nuclear energy	stewart_jacobson_nuclear_energy
rogier van der heide why light needs darkness	van
el seed a project of peace painted across 50 buildings	el
wael ghonim lets design social media that drives real change	wael_social_media_change
zeynep tufekci online social change easy to organize hard to win	zeynep_social_change
bruno torturra got a smartphone start broadcasting	bruno
mariana mazzucato government investor risktaker innovator	mariana_mazzucato_government
michael sandel why we shouldnt trust markets with our civic life	michael_sandel_civic
michael porter the case for letting business solve social problems	michael_business_social
wingham rowan a new kind of job market	wingham
auret van heerden making global labor fair	van_global
jonathan foley the other inconvenient truth	jonathan_foley
ashton applewhite lets end ageism	ashton
ray laurence four sisters in ancient rome	rome_ancient
adrienne mayor did the amazons really exist	adrienne
gayle tzemach lemmon meet the women fighting on the front lines of an american war	tzemach_american_women_war
jake wood a new mission for veterans disaster relief	disaster
shad begum how women in pakistan are creating political change	pakistan_women_change
nighat dad how pakistani women are taking the internet back	pakistani_women_internet
ione wells how we about sexual assault online talk	sexual
zlem cekic why i have coffee with people who send me hate mail	zlem_cekic
dylan marron empathy is not endorsement	dylan_empathy
andrew marantz inside the bizarre world of internet trolls and propagandists	andrew_internet
rodrigo bijou governments dont understand cyber warfare we need hackers	rodrigo_bijou_cyber
christopher soghoian how to avoid surveillance with the phone in your pocket	christopher_surveillance
christopher soghoian government surveillance this is just the beginning	christopher_government_surveillance
juan enriquez your online life permanent as a tattoo	juan
bruce schneier the security mirage	bruce
hasan elahi fbi here i am	hasan_elahi_fbi
richard ledgett the nsa responds to edward snowdens ted talk	richard_ledgett_nsa_edward_ted
glenn greenwald why privacy matters	glenn_greenwald_privacy
jennifer granick how the us government spies on people who protest including you	government
rebecca mackinnon we can fight terror without sacrificing our rights	mackinnon
dan gross why gun violence cant be our new normal	dan_gross_violence
ilona szab de carvalho 4 lessons i learned from taking a stand against drugs and gun violence	szab_carvalho_drugs_violence
jose miguel sokoloff how christmas lights helped guerrillas put down their guns	jose_miguel_christmas
ingrid betancourt what six years in captivity taught me about fear and faith	betancourt_fear
anand giridharadas a letter to all who have lost in this era	anand
anand giridharadas a tale of two americas and the minimart where they collided	anand_tale
alex gendler history vs christopher columbus	alex_christopher_history
mark robinson and alex gendler history vs henry viii	alex_viii_history
brian a pavlac ugly history witch hunts	brian_pavlac_history
janja lalich why do people join cults	janja
teresa bejan is civility a sham	bejan_sham
gretchen carlson david brooks political common ground in a polarized united states	gretchen_carlson_david_brooks_united_states
david brooks should you live for your rsum or your eulogy	david_brooks
stephen cave the 4 stories we tell ourselves about death	stephen_death
nick bostrom a philosophical quest for our biggest problems	nick_bostrom
marvin minsky health and the human mind	marvin_health
elizabeth lesser say your truths and seek them in others	elizabeth
norman lear an entertainment icon on living a life of meaning	norman_entertainment
adam driver my journey from marine to actor	adam_driver_marine
helen marriage public art that turns cities into playgrounds of the imagination	helen_art
nora atkinson why art thrives at burning man	nora_atkinson_art
touria el glaoui inside africas thriving art scene	el_africas_art
camille a brown a visual history of social dance in 25 moves	brown_history_social_dance
prumsodun ok the magic of khmer classical dance	khmer_dance
bill t jones the dancer the singer the cellist and a moment of creative magic	jones
marc pachter the art of the interview	art
ben cameron why the live arts matter	ben
sarah jones what does the future hold 11 characters offer quirky answers	sarah_jones_future
stefon harris there are no mistakes on the bandstand	harris_bandstand
bobby mcferrin watch me play the audience	bobby
tali sharot the optimism bias	tali
peter mendesiedlecki should you trust your first impression	peter_mendesiedlecki
sara garofalo the psychology behind irrational decisions	sara_garofalo_psychology
colm kelleher what is zenos dichotomy paradox	zenos
alex gendler can you solve the multiplying rabbits riddle	alex
nancy duarte the secret structure of great talks	duarte_talks
david s rose how to pitch to a vc	david
carla harris how to find the person who can help you get ahead at work	harris_work
casey brown know your worth and then ask for it	brown
adam galinsky how to speak up for yourself	adam
leila hoteit 3 lessons on success from an arab businesswoman	leila_arab_businesswoman
roxane gay confessions of a bad feminist	feminist
sarah jones one woman five characters and a sex lesson from the future	sarah_jones_sex_future
emily f rothman how porn changes the way teens think about sex	rothman_sex
darieth chisolm how revenge porn turns lives upside down	darieth
laura l dunn its time for the law to protect victims of gender violence	dunn_law_gender_violence
gretchen carlson how we can end sexual harassment at work	gretchen_carlson_sexual_work
ins hercovich why women stay silent after sexual assault	hercovich_women_sexual
shane koyczan to this day for the bullied and beautiful	koyczan
rodrigo y gabriela an electrifying acoustic guitar performance	rodrigo_y_guitar_performance
amanda palmer jherek bischoff usman riaz space oddity	amanda_usman_riaz
amanda palmer the art of asking	amanda
auke ijspeert a robot that runs and swims like a salamander	auke
rodney brooks why we will rely on robots	brooks_robots
jonathan rossiter a robot that eats pollution	jonathan_pollution
asmeret asefaw berhe a climate change solution thats right under our feet	climate_change
greta thunberg the disarming case to act right now on climate change	thunberg_act_climate_change
luisa neubauer why you should be a climate activist	luisa_neubauer_climate
britt wray how climate change affects your mental health	britt_climate_change_mental_health
sean davis can we solve global warming lessons from how we protected the ozone layer	sean_davis
m jackson how to grow a glacier	jackson
dustin schroeder how we look kilometers below the antarctic ice sheet	dustin
robert swan lets save the last pristine continent	robert_swan
ben saunders to the south pole and back the hardest 105 days of my life	ben
lee hotz inside an antarctic time machine	lee_hotz
diana nyad never ever give up	diana
elizabeth leane the dangerous race for the south pole	elizabeth
chris burkard the joy of surfing in icecold water	chris_icecold
david whyte a lyrical bridge between past present and future	david_bridge
robin morgan 4 powerful poems about parkinsons and growing older	morgan
courtney stephens a brief history of melancholy	courtney
sharon horesh bergquist how stress affects your body	sharon_bergquist_body
kelly mcgonigal how to make stress your friend	kelly
ryan martin why we get mad and why its healthy	martin
lisa feldman barrett you arent at the mercy of your emotions your brain creates them	lisa_feldman_barrett_emotions_brain
tiffany watt smith the history of human emotions	tiffany_watt_smith_history_emotions
rana el kaliouby this app knows how you feel from the look on your face	rana_el_kaliouby
feifei li how were teaching computers to understand pictures	li
jeremy howard the wonderful and terrifying implications of computers that can learn	howard_computers
larry page wheres google going next	larry_google
sergey brin why google glass	sergey_brin_google
joshua silver adjustable liquidfilled eyeglasses	joshua
cesar kuriyama one second every day	kuriyama
danny hillis the internet could crash we need a plan b	danny_internet
danny hillis back to the future of 1994	danny_future
danny hillis understanding cancer through proteomics	danny_cancer
andrew blum discover the physical side of the internet	andrew_internet
harald haas wireless data from every light bulb	harald_bulb
eric topol the wireless future of medicine	eric_medicine
jamie heywood the big idea my brother inspired	jamie_heywood
dina katabi a new way to monitor vital signs that can see through walls	dina
radhika nagpal what intelligent machines can learn from a school of fish	fish
noriko arai can a robot pass a university entrance exam	arai
robin hanson what would happen if we upload our brains to computers	computers
roy bahat and bryn freedman how do we find dignity at work	bryn_work
mary roach 10 things you didnt know about orgasm	mary
nina dlvik brochmann and ellen stkken dahl the virginity fraud	nina_brochmann
sarah barmak the uncomplicated truth about womens sexuality	sarah
tiffany kagure mugo and siphumeze khundayi how to have a healthier positive relationship to sex	tiffany_mugo_sex
menno schilthuizen the evolution of animal genitalia	evolution
thomas boothby meet the tardigrade the toughest animal on earth	thomas_tardigrade
kenny coogan why are sloths so slow	kenny
alexandra horowitz how do dogs see with their noses	alexandra_horowitz
david ian howe a brief history of dogs	david_ian_history
lucy cooke sloths the strange life of the worlds slowest mammal	lucy_cooke
suzanne simard how trees to each other talk	suzanne_trees
paul hessburg why wildfires have gotten worse and what we can do about it	paul_hessburg
reniqua allen the story we tell about millennials and who we leave out	allen
chip conley what baby boomers can learn from millennials at work and vice versa	work
roco lorenzo how diversity makes teams more innovative	diversity
mark plotkin what the people of the amazon know that you dont	amazon
mark pagel how language transformed humanity	pagel_language
claire bowern where did english come from	bowern
alexander macdonald how centuries of scifi sparked spaceflight	macdonald_spaceflight
stephen webb where are all the aliens	stephen_webb_aliens
karen j meech the story of oumuamua the first visitor from another star system	karen_oumuamua_star
natasha hurleywalker how radio telescopes show us unseen galaxies	natasha_hurleywalker_telescopes
juna kollmeier the most detailed map of galaxies black holes and stars ever made	juna
burin mutlupakdil a rare galaxy thats challenging our understanding of the universe	mutlupakdil_universe