a colorful case for outside the box thinking on identity	outside_thinking_identity
the lie that invented racism	lie_racism
why we must confront the painful parts of US history	confront_US_history
the racial politics of time	racial_politics
how students of color confront impostor syndrome	students_impostor_syndrome
help for kids the education system ignores	help_kids_education
lets teach for mastery not test scores	teach_mastery_scores
lets use video to reinvent education	video_education
just how small is an atom	small_atom
plankton chronicles project the secret life of plankton	plankton_chronicles_life_plankton
will the ocean ever run out of fish	ocean_out_fish
underwater farms vs climate change	underwater_farms_climate_change
what really happens to the plastic you throw away	plastic_throw
are we running out of clean water	running_clean_water
what would happen if every human suddenly disappeared	happen_human_disappeared
what if cracks in concrete could fix themselves	cracks_concrete_fix_themselves
whats a smartphone made of	smartphone_made
demand a fair trade cell phone	trade_cell_phone
africas cheetahs versus hippos	africas_cheetahs_hippos
aid versus trade	aid_trade
invest in africas own solutions	africas_solutions
in praise of macro yes macro finance in africa	macro_macro_finance_africa
why invest in africa	invest_africa
want to help africa do business here	africa_business
a commodities exchange for ethiopia	commodities_exchange_ethiopia
how i built a windmill	built_windmill
a hero of the congo forest	hero_congo_forest
rebuilding a neighborhood with beauty dignity hope	rebuilding_neighborhood
dont build your home grow it	build_home_grow
architecture that repairs itself	architecture_repairs
using biology to rethink the energy challenge	biology_rethink_energy
a critical look at geoengineering against climate change	geoengineering_climate
salvation and profit in greentech	profit_greentech
new thinking on the climate crisis	climate_crisis
the route to a sustainable future	route_sustainable
cradle to cradle design	cradle_cradle_design
the blur building and other tech empowered architecture	blur_building_tech_architecture
behind the design of seattles library	seattles_library
building a theater that remakes itself	theater_remakes
3 warpspeed architecture tales	warpspeed_architecture
design and destiny	design_destiny
happiness by design	happiness
things ive learned in my life so far	things_learned_life
designing for simplicity	designing
simple designs to save a life	designs_save_life
energy from floating algae pods	energy_floating_algae
plant fuels that could power a jet	plant_fuels_jet
the political chemistry of oil	chemistry_oil
the oil spills unseen villains and victims	oil_spills_villains_victims
how we wrecked the ocean	wrecked_ocean
hooked by an octopus	hooked_octopus
underwater astonishments	underwater
the shrimp with a kick	shrimp_kick
the emergent genius of ant colonies	genius_ant_colonies
my wish build the encyclopedia of life	encyclopedia_life
how humans and animals can live together	humans_animals_together
the gentle genius of bonobos	genius_bonobos
evolutions gift of play from bonobo apes to humans	evolutions_bonobo_apes_humans
play is more than just fun	play_fun
5 dangerous things you should let your kids do	dangerous_things_kids
do schools kill creativity	schools_creativity
the interview sir ken robinson still wants an education revolution	sir_ken_robinson_education_revolution
bring on the learning revolution	learning_revolution
how to escape educations death valley	educations_death_valley
our failing schools enough is enough	failing_schools
every kid needs a champion	kid_champion
a teacher growing green in the south bronx	teacher_green_bronx
teach every child about food	child_food
the killer american diet thats sweeping the planet	killer_american_diet
whats wrong with school lunches	school_lunches
a plantseye view	plantseye
6 ways mushrooms can save the world	mushrooms_save
the fractals at the heart of african designs	fractals_african_designs
biomimicrys surprising lessons from natures engineers	biomimicrys_engineers
robots inspired by cockroach ingenuity	robots_cockroach
a new prosthetic arm for soldiers	prosthetic_soldiers
the potential of regenerative medicine	regenerative_medicine
its time to question bioengineering	bioengineering
the weird wonderful world of bioluminescence	bioluminescence
a dive into the reefs twilight zone	reefs_twilight
the jungle search for viruses	search_viruses
dreams from endangered cultures	endangered_cultures
the worldwide web of belief and ritual	worldwide_belief_ritual
how photography connects us	photography
the passing of time caught in a single photo	time_photo
animal tales from icy wonderlands	icy_wonderlands
the story of a girl	story_girl
photos of endangered cultures	photos_endangered
gorgeous portraits of the worlds vanishing people	portraits_vanishing_people
the silent drama of photography	drama_photography
photos that bear witness to modern slavery	photos_modern_slavery
how to combat modern slavery	combat_slavery
an escape from poverty	poverty
patient capitalism	capitalism
the bottom billion	billion
new insights on poverty	poverty
own your bodys data	bodys_data
the quantified self	self
claim your manspace	manspace
my obsession with objects and the stories they tell	objects_stories
archaeology animal photography bbq	archaeology_animal
the call to learn	learn
unleash your creativity in a fab lab	creativity_fab_lab
everyday inventions	inventions
designing objects that tell stories	objects_stories
organic design inspired by nature	design_nature
magical houses made of bamboo	houses_bamboo
why the buildings of the future will be shaped by you	buildings_future_shaped
how architecture can connect us	architecture_connect
my wish a call for opensource architecture	opensource_architecture
architecture for the people by the people	architecture_people_people
the birth of wikipedia	birth_wikipedia
the web as random acts of kindness	web_random_kindness
the surprising decline in violence	decline_violence
progress is not a zerosum game	progress_zerosum
is this our final century	final_century
10 ways the world could end	world_end
is space trying to kill us	space_kill
could the earth be swallowed by a black hole	earth_swallowed_black_hole
three ways the universe could end	universe_end
what is the universe expanding into	universe_expanding
the life cycle of a neutron star	life_neutron_star
does time exist	time
questions no one knows the answers to	questions_knows_answers
how web video powers global innovation	web_video_innovation
the child driven education	child_education
kids can teach themselves	kids_teach_themselves
build a school in the cloud	school_cloud
teaching one child at a time	teaching_one_child
kids take charge	kids_charge
the fight against sex slavery	fight_sex_slavery
happiness in body and soul	happiness_body_soul
where does creativity hide	creativity_hide
the illustrated woman	illustrated_woman
fashion and creativity	fashion_creativity
the mystery box	mystery_box
my journey into movies that matter	journey_movies
an iraq war movie crowdsourced from soldiers	iraq_movie_crowdsourced_soldiers
the story of ezra	story_ezra
on humanity	humanity
telling stories from africa	stories_africa
how i became an activist	activist
my wish three actions for africa	actions_africa
my wish find the next einstein in africa	einstein_africa
my wish once upon a school	wish_school
how to learn from mistakes	learn_mistakes
what teachers make	teachers
why people believe weird things	believe_weird
a new way to explain explanation	way_explanation
chemical scum that dream of distant quasars	chemical_dream_quasars
how i fell in love with quasars blazars and our incredible universe	love_quasars_blazars_universe
how to land on a comet	land_comet
the real future of space exploration	space_exploration
the astonishing hidden world of the deep ocean	hidden_deep_ocean
this is saturn	saturn
could a saturn moon harbor life	saturn_moon_life
lets look for life in the outer solar system	life_outer_solar_system
the design of the universe	design_universe
what i learned from going blind in space	learned_blind_space
why we need the explorers	need_explorers
what went wrong at the lhc	wrong_lhc
cerns supercollider	cerns_supercollider
making sense of string theory	string_theory
shedding light on dark matter	dark_matter
what we can learn from galaxies far far away	learn_galaxies_far_far_away
the shared wonder of film	wonder_film
my wish a global day of film	global_day_film
how virtual reality can create the ultimate empathy machine	virtual_reality_empathy_machine
visualizing ourselves with crowdsourced data	visualizing_crowdsourced
stunning data visualization in the allosphere	data_visualization_allosphere
a look inside the brain in real time	brain_real_time
3 clues to understanding your brain	clues_brain
visual illusions that show how we misthink	illusions_misthink
art with wire sugar chocolate and string	art_sugar_chocolate_string
my creations a new form of life	creations_form_life
moving sculpture	sculpture
the webs secret stories	webs_stories
the web as art	web_art
software as art	software_art
a new kind of music video	new_music_video
thula mama	thula_mama
woza	woza
tembererana	tembererana
peace on earth	peace_earth
global warmings theme song manhattan in january	global_warmings_song_manhattan
the jill and julia show	jill_julia_show
letting go of god	go_god
lets teach religion all religion in schools	teach_religion_religion_schools
a life of purpose	life_purpose
lose your ego find your compassion	ego_compassion
the profound journey of compassion	journey_compassion
compassion at the dinner table	compassion_table
the evolution of compassion	evolution_compassion
the balancing act of compassion	balancing_compassion
reconnecting with compassion	reconnecting_compassion
my wish the charter for compassion	charter_compassion
we can be buddhas	buddhas
the habits of happiness	habits_happiness
on technology and faith	technology_faith
why would god create a tsunami	god_tsunami
is religion good or bad this is a trick question	religion_good_bad_trick
atheism 20	atheism
a kinder gentler philosophy of success	philosophy_success
your elusive creative genius	elusive_genius
taking imagination seriously	imagination
how to live before you die	live_die
how great leaders inspire action	leaders_inspire
why good leaders make you feel safe	leaders_feel_safe
everyday leadership	leadership
why arent we more compassionate	compassionate
compassion and the true meaning of empathy	compassion_meaning_empathy
the puzzle of motivation	motivation
are we in control of our own decisions	control_decisions
our buggy moral code	buggy_moral
why we make bad decisions	bad_decisions
the surprising science of happiness	science_happiness
want to be happier stay in the moment	happier_stay_moment
flow the secret to happiness	secret_happiness
the new era of positive psychology	era_positive_psychology
the paradox of choice	paradox_choice
how to make hard choices	hard_choices
dont regret regret	regret_regret
on being wrong	wrong
8 secrets of success	8_secrets_success
what i learned from 100 days of rejection	learned_100_days_rejection
your body language may shape who you are	body_language_shape
the power of vulnerability	power_vulnerability
listening to shame	shame
using our practical wisdom	practical_wisdom
our loss of wisdom	loss_wisdom
the lifelong learner	learner
walk the earth my 17 year vow of silence	earth_17_vow_silence
why your worst deeds dont define you	worst_deeds_define
philosophy in prison	philosophy_prison
life science in prison	life_prison
conserving the canopy	conserving_canopy
how to grow a forest in your backyard	grow_forest_backyard
the mysterious lives of giant trees	lives_giant_trees
the worlds oldest living things	oldest_living
my wish manufactured landscapes and green education	landscapes_green_education
turning powerful stats into art	stats_art
fight injustice with raw video	injustice_raw
my wish let my photographs bear witness	photographs_witness
what i saw in the war	saw_war
there are no scraps of men	scraps_men
bringing peace to the minds of afghanistan	peace_minds_afghanistan
the music of a war child	music_war_child
el sistemas top youth orchestra	sistemas_youth_orchestra
the el sistema music revolution	sistema_music
the transformative power of classical music	transformative_classical_music
inventing instruments that unlock new music	instruments_new_music
the untouchable music of the theremin	music_theremin
fiddling in reel time	fiddling_reel
an 11 year olds magical violin	11_magical_violin
an 11 year old prodigy performs oldschool jazz	11_prodigy_oldschool_jazz
robots with soul	robots_soul
dance tiny robots	dance_robots
building selfaware robots	selfaware_robots
the sticky wonder of gecko feet	wonder_gecko_feet
the secrets of natures grossest creatures channeled into robots	creatures_channeled_robots
the dance of the dung beetle	dance_dung_beetle
dragonflies that fly across oceans	dragonflies_oceans
a plea for bees	plea_bees
why bees are disappearing	bees_disappearing
every city needs healthy honey bees	city_healthy_bees
natural pest control using bugs	control_bugs
the magnificence of spider silk	spider_silk
biomimicry in action	biomimicry
using natures genius in architecture	natures_architecture
a vision for sustainable restaurants	sustainable_restaurants
the global food waste scandal	food_waste
how we can eat our landscapes	eat_landscapes
one seed at a time protecting the future of food	seed_protecting_future_food
why we are storing billions of seeds	storing_seeds
humble plants that hide surprising secrets	plants_secrets
the wild world of carnivorous plants	carnivorous_plants
the sexual deception of orchids	deception_orchids
a simple way to tell insects apart	way_insects_apart
why elephants never forget	elephants_forget
claws vs nails	claws_nails
how turtle shells evolved twice	turtle_evolved
the survival of the sea turtle	survival_sea_turtle
how do ocean currents work	ocean_currents
inside the killer whale matriarchy	killer_whale
why do whales sing	whales_sing
why you should care about whale poo	care_whale_poo
my wish protect our oceans	protect_oceans
sampling the oceans dna	oceans_dna
on the verge of creating synthetic life	creating_synthetic_life
can we domesticate germs	domesticate_germs
dna folding in detail	dna_folding
visualizing the wonder of a living cell	visualizing_living_cell
how we discovered dna	discovered_dna
beauty truth and physics	truth_physics
symmetry realitys riddle	symmetry_realitys
an 8dimensional model of the universe	model_universe
how we explore unanswered questions in physics	unanswered_questions_physics
is our universe the only universe	our_universe_universe
questioning the universe	universe
why the universe seems so strange	universe_strange
science versus wonder	science_wonder
parrots the universe and everything	parrots_universe
an inventory of the invisible	inventory_invisible
a one woman global village	woman_village
four american characters	american_characters
singing what i want	singing
kiteflyers hill	kiteflyers_hill
kounandi	kounandi
a one man orchestra of the imagination	orchestra_imagination
nothing but flowers with string quartet	flowers_string_quartet
how architecture helped music evolve	architecture_music
an electrifying organ performance	organ_performance
improvising on piano aged 14	piano_14
why i take the piano on the road and in the air	piano_road_air
great piano performances recreated	piano_performances
in the key of genius	genius
what ive learned from my autistic brothers	autistic_brothers
a tale of mental illness from the inside	mental_illness
how electroshock therapy changed me	electroshock_therapy
the extraordinary power of ordinary people	power_ordinary
expanding your circle of compassion	expanding_compassion
everyday compassion at google	compassion_google
lets revive the golden rule	golden_rule
depression the secret we share	depression_share
confessions of a depressed comic	depressed_comic
whats so funny about mental illness	funny_mental_illness
on being just crazy enough	crazy_enough
the year i was homeless	homeless
what happens when you lose everything	lose_everything
in praise of slowness	slowness
why we should embrace aging as an adventure	aging_adventure
how i became an entrepreneur at 66	entrepreneur_66
this app makes it fun to pick up litter	app_fun_litter
our campaign to ban plastic bags in bali	campaign_plastic_bali
the economic injustice of plastic	injustice_plastic
we can recycle plastic	recycle_plastic
seas of plastic	plastic
tough truths about plastic pollution	plastic_pollution
the surprising solution to ocean plastic	solution_ocean_plastic
how i built a toaster from scratch	toaster_scratch
when ideas have sex	ideas_sex
the era of open innovation	era_innovation
the new power of collaboration	power_collaboration
institutions vs collaboration	institutions_collaboration
the new opensource economics	opensource_economics
life in second life	life_second_life
a glimpse of the future through an augmented reality headset	future_augmented_reality
the accelerating power of technology	power_technology
how technology evolves	technology_evolves
the next 5000 days of the web	5000_days_web
the web as a city	web_city
technologys long tail	technologys
the genesis of google	genesis_google
googles driverless car	googles_driverless
robots that fly and cooperate	robots_fly_cooperate
the surprising habits of original thinkers	habits_original_thinkers
are you a giver or a taker	giver_taker
my year of saying yes to everything	yes_everything
how to use data to make a hit tv show	data_hit_show
the conscience of television	conscience_television
the surprising spread of idol tv	idol_tv
why nations should pursue soft power	soft_power
asias rise how and when	asias_rise
insights on hiv in stunning data visuals	insights_hiv_data
solving medical mysteries	medical_mysteries
how do viruses jump from animals to humans	viruses_animals_humans
what makes tb the worlds most infectious killer	tb_infectious_killer
how close are we to eradicating hiv	eradicating_hiv
what is hpv and how can you protect yourself from it	hpv_protect
how in vitro fertilization ivf works	ivf_works
how does the thyroid manage your metabolism	thyroid_metabolism
why is meningitis so dangerous	meningitis_dangerous
what causes heartburn	heartburn
a lifesaving device that detects silent heart attacks	device_heart_attacks
a new way to heal hearts without surgery	heal_hearts_surgery
surgerys past present and robotic future	surgerys_robotic
a universal translator for surgeons	translator_surgeons
colorcoded surgery	colorcoded_surgery
a test that finds 3x more breast tumors and why its not available to you	3x_breast_tumors_available
opensource cancer research	opensource_cancer
a new strategy in the war on cancer	strategy_cancer
meet the future of cancer research	future_cancer
the future of early cancer detection	future_cancer_detection
a promising test for pancreatic cancer from a teenager	pancreatic_cancer_teenager
yup i built a nuclear fusion reactor	nuclear_fusion_reactor
awardwinning teenage science in action	teenage_science
being young and making an impact	young_impact
the path to ending ethnic conflicts	ethnic_conflicts
my message of peace from pakistan	peace_pakistan
reporting crisis via texting	crisis_texting
how mobile phones can fight poverty	phones_poverty
one laptop per child two years on	laptop_child_two
5 predictions from 1984	5_predictions_1984
a 30 year history of the future	30_history_future
one laptop per child	laptop_child
education innovation in the slums	education_innovation_slums
a short intro to the studio school	intro_studio_school
what adults can learn from kids	adults_learn_kids
how to raise successful kids without overparenting	raise_kids_overparenting
how college loans exploit students for profit	college_loans_profit
what were learning from online education	learning_online
the 100000 student classroom	100000_classroom
a university for the coming singularity	university_singularity
lessons from the 1918 flu	lessons_1918_flu
my wish help me stop pandemics	help_stop_pandemics
how well stop polio for good	stop_polio
moving photos of extreme drug resistant tb	photos_resistant_tb
the face of aids in africa	aids_africa
why i am an hiv aids activist	hiv_activist
mothers helping mothers fight hiv	mothers_mothers_fight_hiv
sex drugs and hiv lets get rational	sex_drugs_hiv
flip your thinking on aids in africa	aids_africa
how juries are fooled by statistics	juries_statistics
learning from the geckos tail	geckos_tail
my seven species of robot and how we created them	seven_species_robot
fly with the jetman	fly_jetman
a plane you can drive	plane_drive
great cars are great art	cars_art
if cars could accidents might be avoidable	cars_accidents_avoidable
the future race car 150mph and no driver	future_car_150mph
the future of cars	future_cars
the future were building and boring	future_boring
the mind behind tesla spacex solarcity	tesla_spacex_solarcity
a new ecosystem for electric cars	electric_cars
high altitude wind energy from kites	wind_energy_kites
a flight on solar wings	solar_wings
nature vs humans	nature_humans
my solar powered adventure	solar_adventure
life at 30000 feet	life_30000_feet
choice happiness and spaghetti sauce	happiness_spaghetti
how to get your ideas to spread	ideas_spread
confessions of a recovering micromanager	confessions_micromanager
why the secret to success is setting the right goals	secret_success_goals
how to build and rebuild trust	build_rebuild_trust
weve stopped trusting institutions and started trusting strangers	trusting_institutions_trusting_strangers
how airbnb designs for trust	airbnb_trust
ubers plan to get more people into fewer cars	ubers_fewer_cars
the hidden world of shadow cities	shadow_cities
photographs of secret sites	secret_sites
why eyewitnesses get it wrong	eyewitnesses_wrong
we need to about an injustice talk	injustice_talk
americas native prisoners of war	americas_native_prisoners
the hidden reason for poverty the world needs to address now	reason_poverty_world
a third way to think about aid	third_way_aid
my wish rebuilding rwanda	rebuilding_rwanda
a hospital tour in nigeria	hospital_nigeria
a parable for kenya	parable_kenya
how to overcome apathy and find your power	apathy_power
reflections from a lifetime fighting to end child poverty	reflections_fighting_child_poverty
3 questions to ask yourself about everything you do	3_questions_everything
the revolutionary power of diverse thought	power_thought
the politics of fiction	politics_fiction
africa is a sleeping giant im trying to wake it up	africa_sleeping_wake
3 ways to uproot a culture of corruption	3_ways_culture_corruption
reducing corruption takes a specific kind of investment	reducing_corruption_investment
three myths about corruption	three_myths_corruption
how to expose the corrupt	expose_corrupt
how open data is changing international aid	data_changing_aid
how to rebuild a broken state	rebuild_broken_state
we need money for aid so lets print it	money_aid_print
lets crowdsource the worlds goals	crowdsource_goals
a visual history of human knowledge	history_human_knowledge
the beauty of data visualization	data_visualization
is pivot a turning point for web exploration	pivot_web_exploration
how photosynth can connect the worlds images	photosynth_connect_images
free or cheap wii remote hacks	wii_remote_hacks
rethink the desktop with bumptop	desktop_bumptop
whats the next window into our universe	window_universe
a 3d atlas of the universe	3d_atlas_universe
the death of the universe	death_universe
dark matter the matter we cant see	dark_matter_matter_see
how ligo discovered gravitational waves and what might be next	ligo_gravitational_waves
what the discovery of gravitational waves means	discovery_gravitational_waves
this telescope might show us the beginning of the universe	telescope_beginning_universe
the search for planets beyond our solar system	search_planets_beyond_solar
how mars might hold the secret to the origin of life	might_origin_life
the story behind the mars rovers	story_mars_rovers
your kids might live on mars heres how theyll survive	kids_live_mars_survive
lets not use mars as a backup planet	mars_backup_planet
the flowershaped starshade that might help us detect earthlike planets	starshade_detect_earthlike
join the seti search	seti_search
a theory of earths mass extinctions	theory_mass_extinctions
the roots of plant intelligence	plant_intelligence
how bacteria talk	bacteria
the beautiful math of coral	math_coral
why i still have hope for coral reefs	hope_coral_reefs
how were growing baby corals to rebuild reefs	growing_corals_rebuild_reefs
how i teach kids to love science	kids_love_science
a novel idea for cleaning up oil spills	idea_cleaning_oil_spills
how arduino is opensourcing imagination	arduino_opensourcing_imagination
the art of wearable communication	art_wearable_communication
haunting photos of polar ice	photos_polar_ice
timelapse proof of extreme ice loss	proof_ice_loss
why did i ski to the north pole	ski_north_pole
the surprising thing i learned sailing solo around the world	sailing_solo_world
let the environment guide our development	environment_development
what comes after an inconvenient truth	inconvenient_truth
averting the climate crisis	climate_crisis
the business logic of sustainability	business_sustainability
lets go all in on selling sustainability	selling_sustainability
hedonistic sustainability	hedonistic_sustainability
design explained	design
design and discovery	design_discovery
my life in typefaces	life_typefaces
making sense of maps	sense_maps
cute sexy sweet funny	cute_sexy_sweet_funny
the moral roots of liberals and conservatives	roots_liberals_conservatives
can a divided america heal	divided_america_heal
what to trust in a posttruth world	trust_posttruth
3 ways to spot a bad statistic	3_spot_statistic
the spellbinding art of human anatomy	art_human_anatomy
every piece of art youve ever wanted to see up close and searchable	art_up_close_searchable
tidying up art	tidying_art
nerdcore comedy	nerdcore_comedy
aliens love where are they	aliens_love
how movies teach manhood	movies_manhood
a cinematic journey through visual effects	cinematic_journey_visual
the art of creating awe	art_awe
the clues to a great story	clues_great_story
before avatar a curious boy	avatar_boy
how benjamin button got his face	benjamin_button_face
animating a photoreal digital face	animating_photoreal_face
the search for the true face of leonardo	search_face_leonardo
revealing the lost codex of archimedes	revealing_codex_archimedes
a free digital library	digital_library
the web is more than better tv	web_better_tv
whats the fastest way to alphabetize your bookshelf	alphabetize_bookshelf
whats an algorithm	algorithm
how exactly does binary code work	binary_code
hire the hackers	hire_hackers
the real story of mcmafia how global crime networks work	story_mcmafia_crime_networks
the deadly genius of drug cartels	genius_drug_cartels
the good news on poverty yes theres good news	good_news_poverty_good_news
global population growth box by box	global_population_growth
we need to feed the whole world	feed_whole_world
cooking as alchemy	cooking_alchemy
sustainable seafood lets get smart	sustainable_seafood
how i fell in love with a fish	love_fish
a foie gras parable	foie_gras_parable
how food shapes our cities	food_shapes_cities
what squatter cities can teach us	squatter_cities
the ghastly tragedy of the suburbs	tragedy_suburbs
lets rethink americas military strategy	rethink_americas_military
a roadmap to end aging	roadmap_end_aging
healing through diet	healing_diet
why dieting doesnt usually work	dieting_doesnt
how an obese town lost a million pounds	obese_town_lost_pounds
the walkable city	walkable_city
new yorks streets not so mean any more	new_yorks_streets_mean
take turns	turns
dont ask where im from ask where im a local	where_from_where_local
be suspicious of simple stories	suspicious_stories
how ideas trump crises	ideas_crises
global priorities bigger than climate change	priorities_climate_change
poverty money and love	poverty_money_love
you are the future of philanthropy	future_philanthropy
the investment logic for sustainability	investment_sustainability
an engineers vision for tiny forests everywhere	engineers_vision_forests
opensourced blueprints for civilization	opensourced_blueprints_civilization
we are makers	makers
life lessons through tinkering	lessons_tinkering
teach statistics before calculus	statistics_calculus
a call to reinvent liberal arts education	reinvent_liberal_education
a passionate personal case for education	passionate_case_education
new data on the rise of women	data_rise_women
women entrepreneurs example not exception	women_entrepreneurs_example
this isnt her mothers feminism	mothers_feminism
a navy admirals thoughts on global security	navy_admirals_global_security
how cyberattacks threaten realworld peace	cyberattacks_peace
cracking stuxnet a 21st century cyber weapon	stuxnet_21st_cyber_weapon
a prediction for the future of iran	prediction_future_iran
politics and religion are technologies	politics_religion_technologies
dangerous memes	dangerous_memes
memes and temes	memes_temes
the illusion of consciousness	illusion_consciousness
how brain science will change computing	brain_science_computing
a computer that works like the brain	computer_brain
my stroke of insight	insight
the brain changing benefits of exercise	brain_benefits_exercise
what you can do to prevent alzheimers	prevent_alzheimers
experiments that hint of longer lives	experiments_longer_lives
the life code that will reshape the future	code_reshape_future
genomics 101	genomics_101
watch me unveil synthetic life	synthetic_life
the next species of human	species_human
will our kids be a different species	kids_different_species
you can grow new brain cells heres how	grow_brain_cells
can the damaged brain repair itself	damaged_brain_repair
growing evidence of brain plasticity	evidence_brain_plasticity
a monkey that controls a robot with its thoughts no really	monkey_controls_robot_thoughts
how to look inside the brain	inside_brain
how your brain tells you where you are	brain_tells_where
the real reason for brains	reason_brains
suddenly my body	body
unlock the intelligence passion greatness of girls	intelligence_passion_girls
a realistic vision for world peace	vision_world_peace
the technology of the heart	technology_heart
the empathic civilization	empathic_civilization
lifes third act	lifes_third_act
the hunt for unexpected genetic heroes	hunt_genetic_heroes
lets pool our medical data	pool_medical
what doctors dont know about the drugs they prescribe	doctors_drugs_prescribe
a doctors touch	doctors
your health depends on where you live	health_live
mapping the future of countries	future_countries
a web for global good	global_good
global ethic vs national interest	ethic_national
the inside story of the paris climate agreement	paris_climate_agreement
why climate change is a threat to human rights	climate_threat_human
the magic of the amazon a river that flows invisibly all around us	magic_amazon_river_invisibly
glimpses of a pristine ocean	glimpses_ocean
glowing life in an underwater world	life_underwater
how we found the giant squid	giant_squid
life in the deep oceans	life_oceans
dead stuff the secret ingredient in our food chain	dead_ingredient_food
should we eat bugs	eat_bugs
the loathsome lethal mosquito	mosquito
how did feathers evolve	feathers
why cant some birds fly	birds_fly
why dont poisonous animals poison themselves	animals_poison
can animals be deceptive	animals_deceptive
why do cats act so weird	cats_weird
the history of the world according to cats	history_world_cats
history through the eyes of a chicken	history_chicken
a brief history of cheese	history_cheese
the fascinating history of cemeteries	history_cemeteries
if superpowers were real immortality	superpowers_immortality
superpowers were real flight	superpowers_flight
if superpowers were real body mass	superpowers_body
if superpowers were real super speed	superpowers_speed
if superpowers were real invisibility	superpowers_invisibility
what are those floaty things in your eye	floaty_eye
why do we cry the three types of tears	cry_types_tears
the science of hearing	hearing
this simple test can help kids hear better	test_kids_hear
help discover ancient ruins before its too late	discover_ancient_ruins
hunting for perus lost civilizations with satellites	perus_civilizations_satellites
archaeology from space	archaeology_space
ancient wonders captured in 3d	wonders_3d
the history of our world in 18 minutes	history_world_18_minutes
technologys epic story	technologys
how to be team human in the digital future	human_digital_future
were building a dystopia just to make people click on ads	dystopia_people_click_ads
machine intelligence makes human morals more important	machine_intelligence_morals
how computers are learning to be creative	computers_creative
augmented reality maps	augmented_reality
tour microsofts virtual earth	microsofts_earth
your phone company is watching	phone_watching
6 ways to save the internet	save_internet
how social media can make history	social_media_history
the voices of twitter users	voices_twitter
what consumers want	consumers
the power of the informal economy	informal_economy
technology crafts for the digitally underserved	technology_underserved
lets bridge the digital divide	bridge_digital
massive scale online collaboration	online_collaboration
after your final status update	status_update
how the internet enables intimacy	internet_intimacy
the anthropology of mobile phones	anthropology_mobile
design and the elastic mind	design_mind
treat design as art	design_art
designers think big	designers
tales of creativity and play	creativity_play
great design is serious not solemn	design_serious
designing books is no laughing matter ok it is	books_laughing
lessons from past presidents	lessons_presidents
planning for the end of oil	planning_oil
lets transform energy with natural gas	energy_natural_gas
fusion is energys future	fusion_future
4 environmental heresies	environmental_heresies
how synchronized hammer strikes could generate nuclear fusion	synchronized_strikes_nuclear_fusion
a 40 year plan for energy	40_plan_energy
my radical plan for small nuclear fission reactors	plan_fission_reactors
my invention that made peace with lions	invention_peace_lions
how poachers became caretakers	poachers_caretakers
what i learned from nelson mandela	nelson_mandela
the voice of the natural world	voice_natural_world
the hidden beauty of pollination	beauty_pollination
exposing the invisible	invisible
my underground art explorations	underground_art
a park underneath the hustle and bustle of new york city	park_new_york
building a park in the sky	park_sky
a memorial at ground zero	memorial
a memorial at ground zero	memorial
the ancient ingenuity of water harvesting	ingenuity_water_harvesting
learn to use the 13th century astrolabe	13th_astrolabe
sputnik mania	sputnik
how to survive a nuclear attack	survive_nuclear
the world doesnt need more nuclear weapons	world_more_nuclear
we need nuclear power to solve climate change	nuclear_power_climate
want to innovate become a nowist	innovate_nowist
from mach 20 glider to hummingbird drone	mach_20_hummingbird_drone
my dream of a flying car	dream_flying_car
a flight through the ocean	flight_ocean
how big is the ocean	big_ocean
how tsunamis work	tsunamis
the physics of surfing	physics_surfing
how rollercoasters affect your body	rollercoasters_body
the physics of the hardest move in ballet	physics_move_ballet
ballroom dance that breaks gender roles	ballroom_dance_gender
a dance in a hurricane of paper wind and light	dance_hurricane_wind_light
in the internet age dance evolves	internet_dance_evolves
a dance of symbiosis	dance_symbiosis
awoo	awoo
redemption song	redemption
lifers a moving song from women in prison for life	lifers_song_prison
lessons in business from prison	business_prison
how prisons can help inmates live meaningful lives	prisons_inmates_lives
from death row to law graduate	death_row_graduate
what i learned serving time for a crime i didnt commit	serving_time_crime
how jails extort the poor	jails_poor
how were priming some kids for college and others for prison	priming_kids_college_prison
a father daughter dance in prison	father_daughter_dance
a father daughter bond one photo at a time	father_daughter_bond
the mothers who found forgiveness friendship	mothers_forgiveness_friendship
my father the forger	father_forger
why should you read the master and margarita	master_margarita
why should you read crime and punishment	read_crime_punishment
titan of terror the dark imagination of hp lovecraft	titan_terror_hp_lovecraft
why should you read edgar allan poe	read_edgar_allan_poe
why should you read one hundred years of solitude	read_hundred_years_solitude
why should you read a midsummer nights dream	read_midsummer_nights_dream
why should you read shakespeares the tempest	read_shakespeares_tempest
why should you read fahrenheit 451	read_fahrenheit_451
why should you read kurt vonnegut	read_kurt_vonnegut
why should you read don quixote	read_don_quixote
why should you read flannery oconnor	read_flannery_oconnor
the wicked wit of jane austen	wit_jane_austen
why should you read scifi superstar octavia e butler	read_scifi_octavia_butler
are elvish klingon dothraki and navi real languages	elvish_klingon_dothraki_navi_languages
why is there a b in doubt	b_doubt
what is verbal irony	verbal_irony
situational irony the opposite of what you think	situational_irony_opposite
what orwellian really means	orwellian
beautiful new words to describe obscure emotions	words_obscure_emotions
go ahead make up new words	new_words
the joy of lexicography	lexicography
the opposites game	game
first kiss	first_kiss
why should you read sylvia plath	read_sylvia_plath
if i should have a daughter	have_daughter
poems of war peace women power	poems_war_peace_women_power
how i use the drum to tell my story	drum_tell_story
a call to men	call_men
violence against women its a mens issue	violence_women_mens
why domestic violence victims dont leave	domestic_violence_victims
how we turned the tide on domestic violence hint the polaroid helped	turned_domestic_violence_polaroid
the brain in love	brain_love
why we love why we cheat	love_cheat
love youre doing it wrong	love_wrong
how i hacked online dating	hacked_online_dating
a vision of crimes in the future	vision_crimes_future
the case for anonymity online	anonymity_online
why videos go viral	videos_viral
how to engineer a viral music video	engineer_viral_music
glorious visions in animation and performance	visions_animation_performance
on violin and cello passacaglia	violin_cello_passacaglia
music is medicine music is sanity	music_medicine_music_sanity
the 4 ways sound affects us	4_ways_sound
everything you hear on film is a lie	hear_film_lie
the unexpected beauty of everyday sounds	everyday_sounds
a history of the universe in sound	history_universe_sound
the sound the universe makes	sound_universe
can a black hole be destroyed	black_hole_destroyed
inside the black hole image that made history	black_hole_image_history
adventures of an asteroid hunter	asteroid_hunter
how to defend earth from asteroids	defend_earth_asteroids
finding planets around other stars	planets_stars
how we found hundreds of potential earthlike planets	found_earthlike_planets
how spectroscopy could reveal alien life	spectroscopy_alien_life
why earth may someday look like mars	earth_look_mars
how humans could evolve to survive in space	humans_survive_space
how well find life on other planets	life_planets
the untapped genius that could change science for the better	genius_science_better
my road trip through the whitest towns in america	road_trip_whitest_towns_america
how to raise a black son in america	raise_black_son_america
the danger of silence	danger_silence
please dont take my air jordans	take_air_jordans
mockingbird remix of ted 2006	mockingbird_remix_ted_2006
a powerful poem about what it feels like to be transgender	poem_feels_transgender
fifty shades of gay	shades_gay
the myth of the gay agenda	myth_gay_agenda
a message to gay teens it gets better	message_gay_teens
did the global response to 911 make us safer	response_911_safer
why global jihad is losing	global_jihad
faith versus tradition in islam	faith_tradition_islam
superheroes inspired by islam	superheroes_islam
east vs west the myths that mystify	east_west_myths
the rise of cricket the rise of india	rise_cricket_rise_india
ideas for indias future	indias_future
new rules for rebuilding a broken nation	rules_rebuilding_nation
in defense of dialogue	defense_dialogue
an independent diplomat	independent_diplomat
our centurys greatest injustice	centurys_injustice
radical women embracing tradition	radical_women_tradition
why not make video games for girls	video_games_girls
are games better than life	games_life
what streaming means for the future of entertainment	streaming_future_entertainment
3 lessons on decision making from a poker champion	lessons_decision_poker
the math behind basketballs wildest moves	math_basketballs_moves
are athletes really getting faster better stronger	athletes_faster_stronger
extreme swimming with the worlds most dangerous jellyfish	swimming_dangerous_jellyfish
my mind shifting everest swim	shifting_everest_swim
how i swam the north pole	swam_north_pole
why bother leaving the house	leaving_house
a leap from the edge of space	edge_space
if superpowers were real super strength	superpowers_super_strength
a broken body isnt a broken person	broken_body_broken
the hunt for general tso	general_tso
why not eat insects	eat_insects
the future of good food in china	future_food_china
a global food crisis may be less than a decade away	global_food_crisis
a forgotten ancient grain that could help africa prosper	ancient_grain_africa
who belongs in a city	belongs_city
the sacred art of the ori	sacred_art_ori
can art amend history	art_history
architecture thats built to heal	architecture_heal
why great architecture should tell a story	architecture_story
how to reinvent the apartment building	reinvent_apartment
architecture at home in its community	architecture_home_community
my green agenda for architecture	agenda_architecture
stunning buildings made from raw imperfect materials	buildings_imperfect_materials
buildings that blend nature and city	buildings_nature_city
design at the intersection of technology and biology	design_technology_biology
the first secret of design is noticing	secret_design
hightech art with a sense of humor	hightech_art_humor
art of substance and absence	art_substance_absence
a next generation digital book	digital_book
using tech to enable dreaming	tech_dreaming
the technology of storytelling	technology_storytelling
my web playroom	web_playroom
why i live in mortal dread of public speaking	dread_public_speaking
poetry of youth and age	poetry_youth_age
once upon a time my mother	time_mother
the 3 as of awesome	awesome
happiness and its surprises	happiness_surprises
the riddle of experience vs memory	experience_memory
what the social progress index can reveal about your country	social_progress_index_country
which country does the most good for the world	country_good_world
who would the rest of the world vote for in your countrys election	world_vote_countrys_election
its time for women to run for office	time_women_office
the career advice you probably didnt get	career_advice
why we have too few women leaders	few_women_leaders
so we leaned in now what	leaned_now
a girl who demanded school	girl_demanded_school
dare to educate afghan girls	educate_afghan_girls
how i stopped the taliban from shutting down my school	taliban_shutting_school
the hidden light of afghanistan	hidden_afghanistan
women wartime and the dream of peace	women_wartime_peace
time to end the war in afghanistan	war_afghanistan
how i defend the rule of law	defend_rule_law
how to stop torture	stop_torture
whats the right thing to do	right_thing
laws that choke creativity	laws_creativity
reexamining the remix	remix
lessons from fashions free culture	lessons_fashions_culture
why sopa is a bad idea	sopa_bad_idea
how youtube thinks about copyright	youtube_copyright
how much does a video weigh	video_weigh
comics that ask what if	comics_ask
a performance of mathemagic	mathemagic
brain magic	brain_magic
mentalism mind reading and the art of getting inside your head	mentalism_art_inside_head
the end of history illusion	history_illusion
how playing an instrument benefits your brain	instrument_benefits_brain
why we love repetition in music	love_repetition_music
why should you listen to vivaldis four seasons	listen_vivaldis_four_seasons
how to read music	read_music
how to practice effectively for just about anything	practice_effectively_anything
what is bipolar disorder	bipolar_disorder
the world needs all kinds of minds	world_minds
the forgotten history of autism	history_autism
autism what we know and what we dont know yet	autism_know_know
a new way to diagnose autism	diagnose_autism
how autism freed me to be myself	autism_freed
the cheap allterrain wheelchair	allterrain_wheelchair
engineering a better life for all	engineering_life
sanitation is a basic human right	sanitation_human_right
lets crap seriously talk	seriously_talk
how to make filthy water drinkable	water_drinkable
human centered design	human_design
design is in the details	design_details
how giant websites design for you and a billion others too	websites_design_billion
meet the water canary	water_canary
how to keep rivers and streams flowing	rivers_streams_flowing
3 thoughtful ways to conserve water	3_ways_conserve_water
4 ways we can avoid a catastrophic drought	4_ways_catastrophic_drought
a country with no water	country_no_water
climate change is happening heres how we adapt	climate_change_adapt
put a value on nature	value_nature
profits not always the point	profits_point
the case for collaborative consumption	collaborative_consumption
the 4 commandments of cities	4_commandments_cities
why mayors should rule the world	mayors_rule
how art gives shape to cultural change	art_cultural_change
clonie	clonie
the dog song	dog_song
mother of pearl if i had you	mother_pearl
the debut of the british paraorchestra	debut_british_paraorchestra
how sampling transformed music	sampling_music
embrace the remix	embrace_remix
how to build your creative confidence	build_creative_confidence
creative houses from reclaimed stuff	creative_houses_reclaimed
why a good book is a secret door	good_book_secret
how a boy became an artist	boy_artist
why lunch ladies are heroes	lunch_heroes
teach arts and sciences together	arts_sciences
how art technology and design inform creative leaders	art_technology_design_creative
my journey in design	journey_design
3 ways good design makes you happy	3_ways_design_happy
how beauty feels	beauty
a darwinian theory of beauty	darwinian_theory
what our language habits reveal	language_habits
the ancestor of language	ancestor_language
my glacier cave discoveries	glacier_discoveries
deep under the earths surface discovering beauty and science	deep_earths_surface_beauty_science
whats left to explore	left_explore
are we filtering the wrong microbes	wrong_microbes
the tradeoffs of building green	tradeoffs_green
how behavioral science can lower your energy bill	science_energy_bill
could your language affect your ability to save money	language_ability_save_money
lets put birth control back on the agenda	birth_control_agenda
how mr condom made thailand a better place for life and love	mr_condom_thailand_life_love
how i started a sanitary napkin revolution	sanitary_napkin_revolution
indias invisible innovation	indias_innovation
how india could pull off the worlds most ambitious energy transition	india_energy_transition
the state of the climate crisis in 2020	climate_crisis_2020
giant ant why is the world warming up	giant_ant_world_warming
giant ant where does all the carbon we release go	giant_ant_carbon_release
why is 15 degrees such a big deal	15_degrees_big_deal
what is netzero	netzero
10 years to transform the future of humanity or destabilize the planet	10_years_transform_future_humanity_planet
how cities are detoxing transportation	detoxing_transportation
saving the ocean one island at a time	saving_ocean_island
the oceans glory and horror	oceans_glory_horror
tagging tuna in the deep ocean	tuna_deep_ocean
learning from sherman the shark	sherman_shark
comics of bygone new york	comics_new_york
the visual magic of comics	visual_magic_comics
an illustrated journey through rome	illustrated_journey_rome
my days as a young rebel	young_rebel
a master architect asks now what	master_architect
a tour of modern architecture	tour_modern_architecture
building uniqueness	uniqueness
how we can design timeless cities for our collective future	design_cities_future
victims of the city	victims_city
how economic inequality harms societies	economic_inequality_societies
doesnt everyone deserve a chance at a good life	deserve_good_life
everyone around you has a story the world needs to hear	story_world_hear
my wish use art to turn the world inside out	wish_art_world_inside_out
retouching lives through photos	retouching_lives_photos
this is what enduring love looks like	enduring_love
the amazing story of the man who gave us modern pain relief	story_modern_pain_relief
how do we heal medicine	heal_medicine
its time to redesign medical data	redesign_medical_data
what makes us get sick look upstream	sick_look_upstream
health care should be a team sport	health_care_team_sport
my wish three unusual medical inventions	three_medical_inventions
parkinsons depression and the switch that might turn them off	parkinsons_depression_switch_off
your brain is more than a bag of chemicals	brain_bag_chemicals
reengineering the brain	reengineering_brain
a brain in a supercomputer	brain_supercomputer
what is so special about the human brain	special_human_brain
the quest to understand consciousness	understand_consciousness
a map of the brain	map_brain
the neurons that shaped civilization	neurons_civilization
what hallucination reveals about our minds	hallucination_minds
how we read each others minds	read_minds
beware neurobunk	neurobunk
the mysterious workings of the adolescent brain	workings_adolescent_brain
what do babies think	babies_think
the linguistic genius of babies	linguistic_genius_babies
a word game to communicate in any language	word_game_communicate
thoughts on humanity fame and love	humanity_fame_love
why the only future worth building includes everyone	future_building
our moral imperative to act on climate change and 3 steps we can take	moral_imperative_climate_change
this decade calls for earthshots to repair our planet	earthshots_repair_planet
the city planting a million trees in two years	planting_trees
climate justice cant happen without racial justice	climate_justice_racial_justice
the energy africa needs to develop and fight climate change	energy_africa_climate_change
to save the climate we have to reimagine capitalism	save_climate_capitalism
apples promise to be carbon neutral by 2030	apples_carbon_neutral_2030
amazons climate pledge to be netzero by 2040	amazons_climate_netzero_2040
the case for stubborn optimism on climate	stubborn_optimism_climate
how to shift your mindset and choose your future	shift_mindset_future
battle climate change will displace millions heres how we prepare	climate_change_displace
why lakes and rivers should have the same rights as humans	lakes_rivers_rights_humans
a creative solution for the water crisis in flint michigan	solution_water_crisis_flint_michigan
family hope and resilience on the migrant trail	family_hope_resilience_migrant
the fundamental right to seek asylum	fundamental_right_asylum
what does it mean to be a refugee	mean_refugee
accents	accents
the benefits of a bilingual brain	benefits_bilingual_brain
should you trust unanimous decisions	unanimous_decisions
the difference between classical and operant conditioning	classical_operant_conditioning
the psychology of posttraumatic stress disorder	psychology_posttraumatic_disorder
could a drug prevent depression and ptsd	drug_depression_ptsd
our lonely society makes it hard to come home from war	lonely_society_home_war
the chilling aftershock of a brush with death	aftershock_brush_death
why i chose a gun	chose_gun
pay attention to nonviolence	attention_nonviolence
how women wage conflict without violence	women_conflict_violence
how to topple a dictator	topple_dictator
inside the egyptian revolution	egyptian_revolution
a historic moment in the arab world	historic_moment_arab
a global culture to fight extremism	global_culture_extremism
terrorism is a failed brand	terrorism_failed
the intricate economics of terrorism	economics_terrorism
navigating our global future	navigating_future
the earth is full	earth_full
abundance is our future	abundance_future
how fast are you moving right now	fast_moving_now
is there a center of the universe	center_universe
what is the universe made of	universe_made
how big is infinity	big_infinity
the unexpected math behind van goghs starry night	math_van_goghs_starry_night
who decides what art means	art_means
why dont perpetual motion machines ever work	perpetual_motion_work
can you survive nuclear fallout	survive_nuclear_fallout
why civilians suffer more once a war is over	civilians_suffer_war_over
what its like to be a parent in a war zone	parent_war_zone
two nameless bodies washed up on the beach here are their stories	nameless_bodies_beach_stories
lets help refugees thrive not just survive	refugees_thrive_survive
a boat carrying 500 refugees sunk at sea the story of two survivors	500_refugees_sea_two_survivors
dont feel sorry for refugees believe in them	sorry_refugees_believe
the refugee crisis is a test of our character	refugee_crisis_character
this is what democracy looks like	democracy_looks
how and why russia hacked the us election	russia_hacked_election
everyday cybercrime and what you can do about it	everyday_cybercrime_about
hackers the internets immune system	hackers_internets_immune
the case for a decentralized internet	decentralized_internet
how technology can fight extremism and online harassment	technology_extremism_online_harassment
how young people join violent extremist groups and how to stop them	young_extremist_groups_stop
iran and israel peace is possible	iran_israel_peace
did you hear the one about the iranian american	hear_iranian_american
the axis of evil middle east comedy tour	middle_east_comedy_tour
pop culture in the arab world	pop_culture_arab
a saudi an indian and an iranian walk into a qatari bar	saudi_indian_iranian_qatari_bar
three ideas three contradictions or not	three_ideas_three_contradictions
the beauty of being a misfit	beauty_misfit
wisdom from great writers on every year of life	wisdom_writers_year_life
in search of the man who broke my neck	search_man_broke_neck
my escape from north korea	escape_north_korea
escaping the khmer rouge	escaping_khmer_rouge
the infamous and ingenious ho chi minh trail	ho_chi_minh_trail
from enslavement to rebel gladiator the life of spartacus	enslavement_rebel_gladiator_spartacus
did ancient troy really exist	ancient_troy
history vs augustus	history_augustus
how to understand power	understand_power
how to revive your belief in democracy	revive_belief_democracy
theres no such thing as not voting	not_voting
demand a more opensource government	demand_opensource_government
coding a better government	coding_better_government
why good hackers make good citizens	good_hackers_good_citizens
addicted to risk	addicted_risk
photographing the landscape of oil	landscape_oil
a new vision for rebuilding detroit	vision_rebuilding_detroit
new york before the city	new_york_city
floating cities the lego house and other architectural forms of the future	floating_cities_lego_architectural_future
how to transform sinking cities into landscapes that fight floods	sinking_cities_landscapes_floods
the most important thing you can do to fight climate change about it talk	fight_climate_change
can we stop climate change by removing co2 from the air	climate_change_removing_co2
can clouds buy us more time to solve climate change	clouds_solve_climate_change
photos from a storm chaser	photos_storm_chaser
how supercharged plants could slow climate change	supercharged_plants_climate_change
lets launch a satellite to track a threatening greenhouse gas	satellite_track_greenhouse
lets clean up the space junk orbiting earth	clean_space_junk_orbiting
the world is one big dataset now how to photograph it	world_dataset_photograph
why we need to go back to mars	back_mars
our next giant leap	next_leap
zero g flight	zero_g_flight
can technology solve our big problems	technology_solve_problems
3 moons and a planet that could have alien life	3_moons_planet_alien_life
the most mysterious star in the universe	mysterious_star_universe
the secret to scientific discoveries making mistakes	secret_discoveries_mistakes
where did the moon come from a new theory	moon_new_theory
you owe it to yourself to experience a total solar eclipse	experience_solar_eclipse
the hunt for a supermassive black hole	hunt_black_hole
lessons from a solar storm chaser	solar_storm_chaser
what time is it on mars	time_mars
what a planet needs to sustain life	planet_sustain_life
the beautiful future of solar power	future_solar_power
a printable flexible organic solar cell	printable_organic_solar_cell
the thrilling potential for offgrid solar energy	offgrid_solar_energy
the case for optimism on climate change	optimism_climate_change
lets prepare for our new climate	prepare_new_climate
the case for optimism	case_optimism
how the military fights climate change	military_climate_change
whats hidden under the greenland ice sheet	under_greenland_ice
drawings that show the beauty and fragility of earth	drawings_beauty_fragility_earth
the secrets i find on the mysterious ocean floor	secrets_ocean_floor
glow in the dark sharks and other stunning sea creatures	glow_dark_sharks_sea
what are animals thinking and feeling	animals_thinking_feeling
chimps have feelings and thoughts they should also have rights	chimps_feelings_thoughts_rights
what separates us from chimpanzees	separates_chimpanzees
the search for humanitys roots	search_humanitys_roots
dna clues to our inner neanderthal	dna_clues_neanderthal
a dig for humanitys origins	dig_humanitys_origins
how a new species of ancestors is changing our theory of human evolution	new_species_changing_theory_evolution
four billion years of evolution in six minutes	years_evolution_minutes
clues to prehistoric times found in blind cavefish	clues_prehistoric_cavefish
hunting for dinosaurs showed me our place in the universe	dinosaurs_place_universe
digging up dinosaurs	digging_dinosaurs
how we unearthed the spinosaurus	unearthed_spinosaurus
where are the baby dinosaurs	baby_dinosaurs
building a dinosaur from a chicken	dinosaur_chicken
the mysterious world of underwater caves	world_underwater_caves
why are these 32 symbols found in ancient caves all over europe	32_symbols_caves_europe
curating humanitys heritage	humanitys_heritage
why im rowing across the pacific	rowing_pacific
wiring an interactive ocean	interactive_ocean
making law on the high seas	law_seas
a census of the ocean	census_ocean
lets turn the high seas into the worlds largest nature reserve	seas_nature_reserve
how pollution is changing the oceans chemistry	pollution_oceans_chemistry
an underwater art museum teeming with life	underwater_art_museum
a journey through the mind of an artist	journey_artist
sculpting waves in wood and time	waves_wood_time
antigravity sculpture	antigravity_sculpture
what on earth is spin	earth_spin
what is the coldest thing in the world	coldest_world
a solar energy system that tracks the sun	solar_energy_system
a future beyond traffic gridlock	future_traffic_gridlock
why buses represent democracy in action	buses_democracy
the future of business is the mesh	future_business_mesh
the currency of the new economy is trust	currency_economy_trust
what we dont understand about trust	understand_trust
why democracy matters	democracy
the next age of government	next_government
my battle to expose government corruption	battle_government_corruption
how mobile phones helped solve two murders	mobile_solve_murders
beware online filter bubbles	online_filter
a magna carta for the web	magna_carta
the next web	next_web
the global goals weve made progress on and the ones we havent	global_goals_progress
see how the rest of the world lives organized by income	world_organized_income
how not to be ignorant about the world	ignorant_world
the way we think about work is broken	think_work_broken
why gender equality is good for everyone men included	gender_equality_men
how equal do we want the world to be you would be surprised	equal_world
new thoughts on capital in the twenty first century	capital_twenty_first_century
beware fellow plutocrats the pitchforks are coming	plutocrats_pitchforks
does money make you mean	money_mean
how to buy happiness	buy_happiness
the antidote to apathy	antidote_apathy
3 kinds of bias that shape your worldview	3_bias_worldview
the pursuit of ignorance	pursuit_ignorance
what we think we know	think_know
a powerful idea about ideas	idea
the magic of fibonacci numbers	magic_fibonacci
why i fell in love with monster prime numbers	love_prime_numbers
teaching kids real math with computers	kids_math_computers
computing a theory of all knowledge	theory_knowledge
science and democracy	science_democracy
why does the universe exist	universe_exist
how do you explain consciousness	explain_consciousness
our shared condition consciousness	shared_consciousness
your brain hallucinates your conscious reality	hallucinates_conscious_reality
this is your brain on communication	brain_communication
teds secret to great public speaking	teds_secret_speaking
how a startup in the white house is changing business as usual	startup_white_house_business
how the internet will one day transform government	internet_transform_government
four principles for the open world	four_principles_world
connected but alone	connected_alone
we are all cyborgs now	cyborgs
robots that show emotion	robots_emotion
playtime with pleo your robotic dinosaur friend	playtime_pleo_dinosaur
the game layer on top of the world	game_layer_world
when games invade real life	games_real_life
gaming can make a better world	gaming_better_world
how i held my breath for 17 minutes	breath_17_minutes
closeup card magic with a twist	closeup_magic_twist
the art of misdirection	art_misdirection
journey to yoyo mastery	journey_yoyo
dance vs powerpoint a modest proposal	dance_powerpoint
doodlers unite	doodlers
the power of time off	power_time
7 rules for making more happiness	7_rules_happiness
the military case for sharing knowledge	military_knowledge
listen learn then lead	listen_learn_lead
tribal leadership	tribal_leadership
the tribes we lead	tribes_lead
how young blood might help reverse aging yes really	young_blood_reverse_aging
how my dads dementia changed my idea of death and life	dads_dementia_death_life
what makes life worth living in the face of death	life_worth_death
a video game to cope with grief	video_game_grief
how loss helped one artist find beauty in imperfection	loss_artist_imperfection
art can heal ptsds invisible wounds	art_heal_ptsds
how to to veterans about war talk	veterans_war_talk
kids need structure	kids_structure
why veterans miss war	veterans_war
deaf in the military	deaf_military
the best gift i ever survived	gift_survived
really achieving your childhood dreams	achieving_childhood_dreams
nature beauty gratitude	nature_beauty_gratitude
love letters to strangers	letters_strangers
meet the founder of the blog revolution	founder_blog_revolution
you are not alone in your loneliness	alone_loneliness
12 truths i learned from life and writing	12_truths_life_writing
the social animal	social_animal
why we do what we do	do_do
why being respectful to your coworkers is good for business	respectful_coworkers_business
looking for a job highlight your ability not your experience	job_highlight_ability_experience
what makes us feel good about our work	feel_good_work
beware conflicts of interest	conflicts_interest
saving faces a facial surgeons craft	faces_facial_surgeons
growing new organs	growing_organs
printing a human kidney	printing_kidney
leather and meat without killing animals	leather_meat_animals
the promise of research with stem cells	research_stem_cells
could tissue engineering mean personalized medicine	tissue_engineering_personalized
a nextgen cure for killer infections	nextgen_cure_infections
programming bacteria to detect cancer and maybe treat it	programming_bacteria_cancer
experiments that point to a new understanding of cancer	experiments_understanding_cancer
fighting a contagious cancer	fighting_cancer
a simple new blood test that can catch cancer early	blood_test_cancer
this tiny particle could roam your body to find tumors	particle_body_tumors
a new superweapon in the fight against cancer	superweapon_cancer
how cancer cells communicate and how we can slow them down	cancer_cells_communicate_slow
yes i survived cancer but that doesnt define me	survived_cancer_define
how the worst moments in our lives make us who we are	worst_moments_lives
love no matter what	love_matter
lets parenting taboos talk	parenting_taboos
agile programming for your family	agile_programming_family
the council of dads	council_dads
the opportunity of adversity	opportunity_adversity
changing my legs and my mindset	changing_mindset
my 12 pairs of legs	12_pairs_legs
the enchanting music of sign language	music_sign_language
dont kill your language	kill_language
dont insist on english	insist_english
the worlds english mania	english_mania
4 reasons to learn a new language	4_reasons_learn_language
texting is killing language just kidding	texting_killing_language
what makes a word real	word_real
what we learned from 5 million books	learned_5_million_books
weaving narratives in museum galleries	narratives_museum_galleries
10 young indian artists to watch	10_indian_artists_watch
how i became 100 artists	100_artists
the painter and the pendulum	painter_pendulum
an unusual glimpse at celebrity	glimpse_celebrity
photos that changed the world	photos_changed_world
impossible photography	impossible_photography
the nitpicking glory of the new yorkers comma queen	nitpicking_glory_new_yorkers
how to use a semicolon	semicolon
what makes a hero	hero
the irish myth of the giants causeway	irish_myth_causeway
the myth of jason and the argonauts	myth_jason_argonauts
the myth of hercules	myth_hercules
the myth of pandoras box	myth_pandoras
the myth of sisyphus	myth_sisyphus
is there any truth to the king arthur legends	truth_king_arthur
a day in the life of a mongolian queen	day_life_mongolian_queen
a day in the life of an ancient egyptian doctor	ancient_egyptian_doctor
tracking ancient diseases using plaque	ancient_diseases_plaque
are we ready for neoevolution	ready_neoevolution
myths and misconceptions about evolution	myths_evolution
gene editing can now change an entire species forever	gene_editing_species_forever
we can reprogram life how to do it wisely	reprogram_life
what explains the rise of humans	rise_humans
moral behavior in animals	moral_animals
grief and love in the animal kingdom	grief_love_animal
how do animals experience pain	animals_pain
why do animals have such different lifespans	animals_lifespans
to solve old problems study new species	solve_problems_species
mammoths resurrected geoengineering and other thoughts from a futurist	mammoths_resurrected_geoengineering
the dawn of deextinction are you ready	dawn_deextinction
bring back the woolly mammoth	woolly_mammoth
how crispr lets us edit our dna	crispr_edit_dna
could we cure hiv with lasers	cure_hiv_lasers
could a breathalyzer detect cancer	breathalyzer_cancer
the genius of marie curie	marie_curie
is radiation dangerous	radiation
how does anesthesia work	anesthesia
the truth about electroconvulsive therapy ect	electroconvulsive_therapy_ect
the benefits of a good nights sleep	benefits_good_sleep
what would happen if you didnt sleep	happen_sleep
what causes insomnia	insomnia
how does your brain respond to pain	brain_respond_pain
how do pain relievers work	pain_relievers
how do cigarettes affect the body	cigarettes_body
how sugar affects the brain	sugar_brain
sugar hiding in plain sight	sugar_sight
how do carbohydrates impact your health	carbohydrates_health
what is fat	fat
the science of spiciness	science_spiciness
dodge gyotaku the ancient japanese art of printing fish	dodge_gyotaku_japanese_printing_fish
save the oceans feed the world	save_oceans_world
hidden toxins in the fish we eat	toxins_fish_eat
the intriguing sound of marine mammals	sound_marine_mammals
could we speak the language of dolphins	speak_language_dolphins
inside the secret shipping industry	shipping_industry
the four fish were overeating and what to eat instead	four_fish_overeating
the case for fish farming	fish_farming
how to win at evolution and survive a mass extinction	win_evolution_extinction
you have no idea where camels really come from	idea_camels
the coolest animal you know nothing about and how we can save it	coolest_animal_nothing_save
hopeful lessons from the battle to save rainforests	lessons_save_rainforests
why i must speak out about climate change	speak_climate_change
the emergent patterns of climate change	patterns_climate_change
emergency medicine for our climate fever	medicine_climate
a new way to remove co2 from the atmosphere	remove_co2_atmosphere
the power to think ahead in a reckless age	think_ahead_reckless
3 ways to plan for the very long term	3_ways_plan_long
nationalism vs globalism the new political divide	nationalism_globalism_divide
will automation take away all our jobs	automation_jobs
4 ways to build a human company in the age of machines	4_ways_human_company_machines
3 ways to usefully lose control of your brand	lose_control_brand
social media and the end of gender	social_media_gender
dont like clickbait dont click	like_clickbait
lets try emotional correctness	emotional_correctness
take the other to lunch	other_lunch
my year of living biblically	year_biblically
playing invisible turntables	invisible_turntables
my magic moves	magic_moves
juggling as art and science	juggling_art_science
dance to change the world	dance_change
a fullband beatbox	fullband_beatbox
color blind or color brave	color_blind_color_brave
4 pillars of college success in science	college_success_science
hey science teachers make it fun	science_teachers_fun
science is for everyone kids included	science_kids
a 12 year old app developer	12_year_developer
gaming to reengage boys in learning	gaming_boys_learning
teach girls bravery not perfection	girls_bravery
forget the pecking order at work	pecking_order
dare to disagree	dare_disagree
the dangers of willful blindness	willful_blindness
why the world needs wikileaks	world_wikileaks
listening to global voices	global_voices
my wish to launch a new era of openness in business	launch_openness_business
meet global corruptions hidden players	global_corruptions
the panama papers exposed a huge global problem whats next	panama_papers_exposed_problem
how the panama papers journalists broke the biggest leak in history	panama_papers_biggest_leak
heres how we take back the internet	take_back_internet
how the nsa betrayed the worlds trust time to act	nsa_betrayed_trust
the power and the danger of online crowds	power_danger_online
inside the ant colony	ant_colony
what ants teach us about the brain cancer and the internet	ants_brain_cancer_internet
how a fly flies	fly_flies
the loves and lies of fireflies	loves_lies_fireflies
the birds and the bees are just the beginning	birds_bees_beginning
the camels hump	camels_hump
what sticky sea creatures can teach us about making glue	sea_creatures_glue
this deepsea mystery is changing our understanding of life	deepsea_mystery_life
meet the microscopic life in your home and on your face	microscopic_life_home
smelfies and other experiments in synthetic biology	smelfies_synthetic_biology
shapeshifting tech will change work as we know it	shapeshifting_tech_work
the shapeshifting future of the mobile phone	shapeshifting_future_mobile
pointing to the future of ui	future_ui
reach into the computer and grab a pixel	computer_pixel
playing with dna that selfassembles	dna_selfassembles
animations of unseeable biology	animations_biology
can we cure genetic diseases by rewriting dna	cure_genetic_diseases_rewriting
how to create a world where no one dies waiting for a transplant	create_world_dies_transplant
what you need to know about crispr	know_crispr
the era of personal dna testing is here	personal_dna_testing
my dna vending machine	dna_vending
capturing memories in video art	memories_video_art
half a million secrets	secrets
break the silence for suicide attempt survivors	silence_suicide_attempt
the bridge between suicide and life	bridge_suicide_life
the science of sync	science_sync
bridges should be beautiful	bridges_beautiful
why glass towers are bad for city life and what we need instead	glass_towers_city_life
what can we learn from shortcuts	learn_shortcuts
how to revive a neighborhood with imagination beauty and art	revive_neighborhood_imagination
how public spaces make cities work	public_spaces_cities
brilliant designs to fit more people in every city	designs_fit_people_city
the surprising math of cities and corporations	math_cities_corporations
stern the state of the climate and what we might do about it	stern_state_climate_about
the shareable future of cities	shareable_future_cities
the biggest risks facing cities and some solutions	risks_cities_solutions
how to protect fast growing cities from failing	protect_growing_cities
lets treat violence like a contagious disease	violence_contagious
mapping ideas worth spreading	ideas_spreading
the mathematics of war	mathematics_war
simplifying complexity	simplifying_complexity
toward a science of simplicity	science_simplicity
simplicity sells	simplicity_sells
10 top timesaving tech tips	timesaving_tech_tips
cool tricks your phone can do	tricks_phone
tools for a better world	tools_world
how mobile phones power disaster relief	mobile_disaster_relief
when bad engineering makes a natural disaster even worse	engineering_natural_disaster
how to step up in the face of disaster	step_up_disaster
how to motivate people to do good for others	motivate_good_others
why some people are more altruistic than others	people_altruistic
how to let altruism be your guide	altruism_guide
why giving away our wealth has been the most satisfying thing weve done	wealth_satisfying
mosquitos malaria and education	mosquitos_malaria
what we learned from teetering on the fiscal cliff	teetering_fiscal_cliff
how common threats can make common political ground	threats_political_ground
religion evolution and the ecstasy of self transcendence	religion_evolution_transcendence
americas forgotten working class	americas_working_class
the story we tell about poverty isnt true	story_poverty
social experiments to fight poverty	experiments_fight_poverty
the why and how of effective altruism	effective_altruism
inspiring a life of immersion	life_immersion
to solve the worlds biggest problems invest in women and girls	solve_problems_women
why should you read kafka on the shore	read_kafka_shore
what reading slowly taught me about writing	reading_slowly_writing
scifi stories that imagine a future africa	scifi_stories_future_africa
a young poet tells the story of darfur	poet_story_darfur
what will you tell your daughters about 2016	tell_daughters_2016
the urgency of intersectionality	urgency_intersectionality
skin color is an illusion	skin_color_illusion
the science of skin color	science_skin
the beauty of human skin in every color	human_skin_color
a visual history of inequality in industrial america	visual_history_industrial_america
a littletold tale of sex and sensuality	tale_sex_sensuality
hiv how to fight an epidemic of bad laws	hiv_epidemic_laws
the dangerous evolution of hiv	evolution_hiv
our treatment of hiv has advanced why hasnt the stigma changed	treatment_hiv_stigma
ethical riddles in hiv research	riddles_hiv_research
biolab on a microchip	biolab_microchip
a lab the size of a postage stamp	lab_postage_stamp
how i harnessed the wind	harnessed_wind
the birth of the computer	birth_computer
the greatest machine that never was	greatest_machine_never
2600 years of history in one object	2600_years_history
the global power shift	global_shift
on being a woman and a diplomat	woman_diplomat
see yemen through my eyes	yemen_eyes
a saudi woman who dared to drive	saudi_woman_dared
the attitudes that sparked arab spring	attitudes_arab_spring
the political progress women have made and whats next	political_progress_women
a womans fury holds lifetimes of wisdom	womans_fury_wisdom
why im done trying to be man enough	trying_man
a political party for womens equality	political_womens_equality
this tennis icon paved the way for women in sports	tennis_icon_women_sports
making peace is a marathon	peace_marathon
teaching with the world peace game	teaching_world_peace
7 ways games reward the brain	7_ways_reward_brain
your brain on video games	brain_games
gaming for understanding	gaming_understanding
a manifesto for play for bulgaria and beyond	manifesto_play_bulgaria
how to recover from activism burnout	recover_activism_burnout
3 lessons on starting a movement from a selfdefense trailblazer	3_lessons_selfdefense_trailblazer
the most powerful woman youve never heard of	powerful_woman_never
the trauma of systematic racism is killing black women a first step toward change	trauma_racism_black_women_change
how racism makes us sick	racism_sick
the problem with racebased medicine	racebased_medicine
why medicine often has dangerous side effects for women	medicine_effects_women
we need better drugs now	better_drugs
body parts on a chip	body_chip
caring for engineered tissue	engineered_tissue
using nature to grow batteries	grow_batteries
the radical possibilities of manmade dna	possibilities_manmade_dna
how to build synthetic dna and send it across the internet	synthetic_dna_internet
how to read the genome and build a human being	read_genome_human
finding life we cant imagine	life_imagine
making matter come alive	matter_alive
the line between life and notlife	line_life
the science of scent	science_scent
a crash course in organic chemistry	course_organic_chemistry
what the sugar coating on your cells is trying to tell you	sugar_coating_cells
good news in the fight against pancreatic cancer	news_pancreatic_cancer
can we eat to starve cancer	eat_starve_cancer
new nanotech to detect cancer early	nanotech_detect_cancer
we can start winning the war against cancer	war_cancer
could future devices read images from our brains	future_devices_images_brains
a neural portrait of the human mind	neural_portrait_human
diagnosing a zombie brain and body part one	diagnosing_zombie_brain
what causes hallucinations	hallucinations
a graziano what is consciousness	graziano_consciousness
the surprising link between stress and memory	link_stress_memory
how stress affects your brain	stress_brain
what is depression	depression
what is deja vu what is deja vu	deja_vu_deja_vu
dont suffer from your depression in silence	suffer_depression_silence
no shame in taking care of your mental health	shame_mental_health
your words may predict your future mental health	words_predict_mental_health
toward a new understanding of mental illness	understanding_mental_illness
a second opinion on developmental disorders	opinion_developmental_disorders
a warm embrace that saves lives	embrace_saves_lives
what we learn before were born	learn_born
how to live to be 100	live_100
is the obesity crisis hiding a bigger problem	obesity_crisis
visualizing the medical data explosion	visualizing_medical_data
big data is better data	big_data_data
dont fear intelligent machines work with them	fear_intelligent_machines
3 principles for creating safer ai	principles_safer_ai
can we build ai without losing control over it	build_ai_control
what happens when our computers get smarter than we are	computers_smarter
jeopardy and me the obsolete know it all	jeopardy_obsolete_know
get ready for hybrid thinking	hybrid_thinking
the key to growth race with the machines	growth_race_machines
the freakonomics of crack dealing	freakonomics_dealing
the political power of being a good neighbor	power_good_neighbor
3 ways to practice civility	practice_civility
the counter intuitive way to be more persuasive	intuitive_persuasive
how to win an argument at the us supreme court or anywhere	argument_us_supreme_court
the lost art of democratic debate	lost_democratic_debate
four ways to fix a broken legal system	fix_legal_system
how to put the power of law in peoples hands	power_law_peoples
how judges can show respect	judges_respect
community powered criminal justice reform	community_criminal_justice
how police and the public can create safer neighborhoods together	police_public_safer_neighborhoods
i love being a police officer but we need reform	police_officer_reform
can democracy exist without trust	democracy_trust
does democracy stifle economic growth	democracy_economic_growth
understanding the rise of china	rise_china
global power shifts	power_shifts
an economic reality check	economic_reality
the rise of the new global superrich	rise_superrich
who controls the world	controls_world
the secret to great opportunities the person you havent met yet	secret_opportunities_person
the secret to living longer may be your social life	secret_living_longer_social
what makes a good life lessons from the longest study on happiness	life_lessons_study_happiness
technology hasnt changed love heres why	technology_love
falling in love is the easy part	falling_love
a better way to about love talk	way_love_talk
why do we love a philosophical inquiry	love_philosophical_inquiry
the science of attraction	science_attraction
inside okcupid the math of online dating	okcupid_online_dating
how to make applying for jobs less painful	applying_jobs_painful
why you should bring your whole self to work	bring_self_work
this is the side hustle revolution	side_hustle_revolution
this is what makes employees happy at work	employees_happy_work
why working from home is good for business	working_home_business
8 lessons on building a company people enjoy working for	lessons_building_company_people
3 psychological tricks to help you save money	psychological_tricks_save_money
7 common questions about workplace romance	questions_workplace_romance
the difference between healthy and unhealthy love	healthy_unhealthy_love
the gift and power of emotional courage	gift_power_emotional
how i fail at being disabled	fail_disabled
what reality are you creating for yourself	reality_yourself
how i use sonar to navigate the world	sonar_navigate_world
can we create new senses for humans	create_senses_humans
design for all 5 senses	design_5_senses
why i brought pacman to moma	pacman_moma
how games make kids smarter	games_kids_smarter
what young women believe about their own sexual pleasure	women_about_sexual_pleasure
the lies we tell pregnant women	lies_pregnant_women
the reporting system that sexual assault survivors want	reporting_assault_survivors
why i believe the mistreatment of women is the number one human rights abuse	mistreatment_women_human_rights
find your voice against gender violence	voice_gender_violence
how women in rural india turned courage into capital	women_rural_india_courage
how ai can bring on a second industrial revolution	ai_industrial_revolution
how to get empowered not overpowered by ai	empowered_overpowered_ai
what ai is and isnt	ai_isnt
why we need to imagine different futures	imagine_futures
the human skills we need in an unpredictable world	human_skills_unpredictable_world
3 myths about the future of work and why theyre not true	3_myths_future_work
how well earn money in a future without jobs	earn_money_future_jobs
the new american dream	american_dream
a conservatives plea lets work together	conservatives_plea_work
the unstoppable walk to political reform	unstoppable_walk_reform
we the people and the republic we must reclaim	people_republic_reclaim
does your vote count the electoral college explained	vote_count_electoral_college
do politics make us irrational	politics_irrational
how to choose your news	choose_news
this one weird trick will help you spot clickbait	trick_spot_clickbait
can you spot the problem with these headlines level 1	spot_problem_headlines
how one journalist risked her life to hold murderers accountable	journalist_risked_murderers_accountable
notes of a native son the world according to james baldwin	notes_native_son_james_baldwin
the breathtaking courage of harriet tubman	courage_harriet_tubman
the atlantic slave trade what too few textbooks told you	atlantic_slave_trade_textbooks
the symbols of systemic racism and how to take away their power	symbols_racism_power
how my mom inspired my approach to the cello	mom_inspired_cello
an artists unflinching look at racial violence	artists_racial_violence
me too is a movement not a moment	me_too_movement
how online abuse of women has spiraled out of control	online_abuse_women_control
the price of shame	price_shame
a black man goes undercover in the altright	black_man_undercover
how barbershops can keep men healthy	barbershops_healthy
why your doctor should care about social justice	doctor_social_justice
how well fight the next deadly virus	fight_virus
how we must respond to the coronavirus pandemic	respond_coronavirus_pandemic
how can we control the coronavirus pandemic	control_coronavirus_pandemic
on what should and shouldnt worry us about the coronavirus	should_worry_coronavirus
what we do and dont know about the coronavirus	know_coronavirus
what it takes to crush a pandemic	crush_pandemic
why rumors about vaccines spread and how to rebuild trust	rumors_vaccines_rebuild_trust
the trials tribulations and timeline of a covid19 vaccine	trials_timeline_covid19
the quest for the coronavirus vaccine	quest_coronavirus_vaccine
the troubling reason why vaccines are made too late if theyre made at all	reason_vaccines_late
hiv and flu the vaccine strategy	hiv_flu_vaccine
demo a needlefree vaccine patch thats safer and way cheaper	needlefree_vaccine_safer_cheaper
a mobile fridge for vaccines	fridge_vaccines
play experiment discover	experiment_discover
how to stop screwing yourself over	stop_screwing_yourself
why you should define your fears instead of your goals	define_fears_goals
smash fear learn anything	smash_fear
success failure and the drive to keep creating	success_failure_drive
the difference between winning and succeeding	winning_succeeding
what pingpong taught me about life	pingpong_life
what a bike ride can teach you	bike_ride
political change with pen and paper	political_pen_paper
why ordinary people need to understand power	ordinary_understand_power
what if we replaced politicians with randomly selected people	politicians_randomly_people
how protest is redefining democracy around the world	protest_democracy_world
a bold idea to replace politicians	replace_politicians
why fascism is so tempting and how your data could power it	fascism_tempting_data_power
facebooks role in brexit and the threat to democracy	facebooks_brexit_threat_democracy
its not about privacy its about power	privacy_power
why journalists have an obligation to challenge power	journalists_obligation_power
how fake news does real harm	fake_news_harm
if a story moves you act on it	story_act
inside the fight against russias fake news empire	russias_fake_news
why i put myself in danger to tell the stories of gaza	danger_stories_gaza
for more tolerance we need more tourism	tolerance_tourism
street art with a message of hope and peace	street_message_hope_peace
poetry that frees the soul	poetry_soul
why people need poetry	people_poetry
metaphorically speaking	metaphorically
la vie en rose	la_vie_en_rose
a musical escape into a world of light and color	musical_escape_light_color
playing pink noise on guitar	playing_noise_guitar
how i found myself through music	found_music
poetry music and identity	poetry_music_identity
math is forever	math_forever
a love poem for lonely prime numbers	love_poem_prime_numbers
math class needs a makeover	math_makeover
this company pays kids to do their math homework	company_pays_math_homework
math is the hidden secret to understanding the world	math_secret_world
the mathematician who cracked wall street	mathematician_wall_street
the way we think about charity is dead wrong	think_charity_wrong
what nonprofits can learn from cocacola	nonprofits_cocacola
the generosity experiment	generosity_experiment
how cryptocurrency can help startups get investment capital	cryptocurrency_startups_investment
how the blockchain will radically transform the economy	blockchain_transform_economy
how the blockchain is changing money and business	blockchain_money_business
bitcoin sweat tide meet the future of branded currency	bitcoin_branded_currency
sweat the small stuff	sweat_stuff
life lessons from an ad man	life_ad_man
the price of happiness	price_happiness
science can answer moral questions	science_moral_questions
militant atheism	militant_atheism
my failed mission to find god and what i found instead	mission_god_found
the gospel of doubt	gospel_doubt
embrace your raw strange magic	embrace_raw_magic
get comfortable with being uncomfortable	comfortable_uncomfortable
how to find work you love	work_love
meet a young entrepreneur cartoonist designer activist	entrepreneur_cartoonist_designer
lets raise kids to be entrepreneurs	kids_entrepreneurs
the happy secret to better work	happy_secret_work
this is what its really like to live with adhd	live_adhd
what happens in your brain when you pay attention	brain_pay_attention
the brain may be able to repair itself with help	brain_repair_itself
can we regenerate heart muscle with stem cells	regenerate_heart_stem
an intergalactic guide to using a defibrillator	guide_defibrillator
dogfriendly dog training	dogfriendly_training
the first 21 days of a bees life	21_days_bees
hidden miracles of the natural world	miracles_natural_world
the beautiful nano details of our world	nano_details_world
turning dunes into architecture	dunes_architecture
mining minerals from seawater	minerals_seawater
every pollen grain has a story	pollen_story
the beautiful tricks of flowers	tricks_flowers
the evolution of the human eye	evolution_human_eye
how optical illusions trick your brain	optical_illusions_brain
is fire a solid a liquid or a gas	fire_solid_liquid_gas
how crispr lets you edit dna	crispr_edit_dna
you are your microbes	microbes
how do your hormones work	hormones_work
how i help transgender teens become who they want to be	help_transgender
why i must come out	come_out
the way we think about biological sex is wrong	think_biological_sex
the biology of gender from dna to the brain	biology_gender_dna_brain
how early life experience is written into dna	early_life_dna
the ethical dilemma of designer babies	dilemma_designer_babies
a simple birth kit for mothers in the developing world	birth_kit_mothers_world
how racism harms pregnant women and what can help	racism_pregnant_help
how we can improve maternal healthcare before during and after pregnancy	improve_maternal_healthcare_pregnancy
a new way to think about the transition to motherhood	think_transition_motherhood
the us needs paid family leave for the sake of its future	us_family_leave_future
the case for having kids	case_kids
a teen just trying to figure it out	teen_figure
nature is everywhere we just need to learn to see it	nature_everywhere_learn
a guerrilla gardener in south central la	guerrilla_gardener_central
my subversive garden plot	garden_plot
is the world getting better or worse a look at the numbers	world_better_numbers
human nature and the blank slate	human_nature_blank
be an artist right now	artist_now
embrace the shake	embrace_shake
hack a banana make a keyboard	banana_keyboard
building blocks that blink beep and teach	blocks_blink_beep_teach
whats your 200 year plan	200_year_plan
the magic of truth and lies and ipods	magic_truth_lies_ipods
art that looks back at you	art_back
the future of lying	future_lying
how to spot a liar	spot_liar
the pattern behind self deception	pattern_deception
a prosthetic eye to treat blindness	prosthetic_blindness
your brain on improv	brain_improv
we choose to fall out of love	choose_love
3 ways to build a happy marriage and avoid divorce	3_ways_marriage_divorce
what you dont know about marriage	know_marriage
what the gay rights movement learned from the civil rights movement	gay_rights_movement_civil
this is what lgbt life is like around the world	lgbt_life_world
why kids need to learn about gender and sexuality	learn_gender_sexuality
a short history of trans peoples long fight for equality	history_trans_equality
how to and listen to transgender people talk	listen_transgender_talk
why we need genderneutral bathrooms	genderneutral_bathrooms
my daughter my wife our robot and the quest for immortality	daughter_wife_robot_immortality
an astronauts story of curiosity perspective and change	astronauts_perspective_change
6 space technologies we can use to improve life on earth	space_technologies_life_earth
adventures of an interplanetary architect	interplanetary_architect
there might just be life on mars	life_mars
the worlds first crowdsourced space traffic monitoring system	crowdsourced_space_traffic_monitoring
the fundamentals of spacetime part 2	fundamentals_spacetime_part_2
sculpted space within and without	sculpted_space
can you solve the passcode riddle	passcode_riddle
can you solve the stolen rubies riddle	stolen_rubies_riddle
can you solve the leonardo da vinci riddle	solve_leonardo_da_vinci_riddle
can you solve the rogue ai riddle	solve_rogue_ai_riddle
can you solve the mondrian squares riddle	solve_mondrian_squares_riddle
can you solve the giant cat army riddle	solve_giant_cat_army_riddle
can you solve the secret werewolf riddle	solve_secret_werewolf_riddle
can you solve the alien probe riddle	solve_alien_probe_riddle
can you solve the rebel supplies riddle	solve_rebel_supplies_riddle
robots will invade our lives	robots_invade_lives
the rise of personal robots	rise_personal_robots
silicon based comedy	silicon_comedy
why we have an emotional connection to robots	emotional_robots
whats it like to be a robot	like_robot
these robots come to the rescue after a disaster	robots_rescue_disaster
the future of flying robots	future_flying_robots
the astounding athletic power of quadcopters	athletic_power_quadcopters
meet the dazzling flying machines of the future	flying_machines_future
a flying camera on a leash	flying_camera_leash
4 lessons from robots about being human	lessons_robots_human
meet rezero the dancing ballbot	rezero_dancing_ballbot
my quest to defy gravity and fly	quest_defy_gravity
how i climbed a 3000 foot vertical cliff without ropes	climbed_3000_foot_cliff
how well become cyborgs and extend human potential	cyborgs_human_potential
the new bionics that let us run climb and dance	bionics_climb_dance
the mysterious science of pain	science_pain
would you opt for a life with no pain	opt_life_pain
room a philosophical thought experiment	philosophical_thought_experiment
unsolvable enigmas designed to break your brain	enigmas_break_brain
what machiavellian really means	machiavellian_means
history vs napoleon bonaparte	history_napoleon_bonaparte
historys deadliest colors	historys_colors
the worlds most mysterious book	mysterious_book
what really happened to the library of alexandria	library_alexandria
how im discovering the secrets of ancient texts	secrets_ancient_texts
what is a butt tuba and why is it in medieval art	butt_tuba_medieval_art
everything you need to know to read the canterbury tales	read_canterbury_tales
the princess who rewrote history	princess_rewrote_history
how our stories cross over	stories_over
the tragedy of orphanages	tragedy_orphanages
a new way to get every child ready for kindergarten	child_ready_kindergarten
creative ways to get kids to thrive in school	kids_thrive_school
the opportunity gap in us public education and how to close it	opportunity_gap_public_education
grit the power of passion and perseverance	grit_passion_perseverance
how to teach kids to about taboo topics talk	teach_kids_taboo
how we can help the forgotten middle reach their full potential	help_forgotten_middle_potential
why black girls are targeted for punishment at school and how to change that	black_girls_punishment_school
empower a girl transform a community	empower_girl_community
what is imposter syndrome and how can you combat it	imposter_syndrome_combat
how do you know you exist	know_exist
science didnt understand my kids rare disease until i decided to study it	science_kids_disease_study
what happens when you have a disease doctors cant diagnose	disease_doctors_diagnose
why genetic research must be more diverse	genetic_research_diverse
welcome to the genomic revolution	genomic_revolution
his and hers health care	health_care
what if our health care system kept us healthy	health_care_system_healthy
the universal anesthesia machine	universal_anesthesia
how i repaired my own heart	repaired_own_heart
meet epatient dave	epatient_dave
why the hospital of the future will be your own home	hospital_future_home
the hidden role informal caregivers play in health care	informal_caregivers_health_care
a tribute to nurses	tribute_nurses
we need a heroic narrative for death	heroic_narrative_death
life that doesnt end with death	life_end_death
prepare for a good end of life	prepare_end_life
lets about dying talk	dying_talk
my mushroom burial suit	mushroom_burial_suit
a burial practice that nourishes the planet	burial_practice_nourishes
what happens when a city runs out of room for its dead	city_room_dead
theres a better way to die and architecture can help	way_die_architecture
before i die i want to	die_want
what a world without prisons could look like	world_prisons_look
what prosecutors and incarcerated people can learn from each other	prosecutors_incarcerated_people_learn
the surprising connection between brain injuries and crime	connection_brain_injuries
the human stories behind mass incarceration	human_stories_incarceration
how i help free innocent people from prison	free_innocent_prison
what if we ended the injustice of bail	ended_injustice_bail
the neuroscience of restorative justice	neuroscience_justice
why smart statistics are the key to fighting crime	smart_statistics_fighting_crime
is life really that complex	life_complex
how algorithms shape our world	algorithms_shape_world
the era of blind faith in big data must end	era_blind_faith_data
the human insights missing from big data	human_insights_data
your companys data could help end world hunger	data_help_world_hunger
what a driverless world could look like	driverless_world
how a driverless car sees the road	driverless_car_road
making a car for blind drivers	car_blind_drivers
get your next eye exam on a smartphone	eye_exam_smartphone
how lowcost eye care can be worldclass	lowcost_eye_worldclass
what doctors can learn from each other	doctors_learn
pool medical patents save lives	pool_medical_patents
how i beat a patent troll	beat_patent_troll
should you be able to patent a human gene	patent_human_gene
unintended consequences	unintended_consequences
indias hidden hotbeds of invention	indias_hotbeds_invention
breakthrough designs for ultra low cost products	designs_low_cost
solving social problems with a nudge	social_problems_nudge
a skateboard with a boost	skateboard_boost
no roads theres a drone for that	roads_drone	
we are all designers	designers
a mouse a laser beam a manipulated memory	mouse_laser_memory
feats of memory anyone can do	feats_memory
what happens when you remove the hippocampus	remove_hippocampus
debunking the myths of ocd	debunking_ocd
how isolation fuels opioid addiction	isolation_opioid_addiction
the agony of opioid withdrawal and what doctors should tell patients about it	opioid_withdrawal_doctors_patients
the critical role librarians play in the opioid crisis	librarians_opioid_crisis
addiction is a disease we should treat it like one	addiction_disease_treat
everything you think you know about addiction is wrong	think_addiction_wrong
why we need to end the war on drugs	end_war_drugs
the harm reduction model of drug addiction treatment	harm_reduction_addiction
what really happens when you mix medications	happens_mix_medications
the dangers of mixing drugs	dangers_mixing_drugs
how does your body process medicine	body_medicine
the pharmacy of the future personalized pills 3d printed at home	pharmacy_personalized_pills_3d_printed
transplant cells not organs	transplant_cells_organs
how augmented reality could change the future of surgery	augmented_reality_surgery
lifelike simulations that make reallife surgery safer	simulations_reallife_surgery
a tool to fix one of the most dangerous moments in surgery	tool_fix_dangerous_surgery
ultrasound surgery healing without cuts	ultrasound_healing
treating cancer with electric fields	treating_cancer_electric
how do we learn to work with intelligent machines	learn_work_machines
how ai can save our humanity	ai_save_humanity
how ai can enhance our memory work and social lives	ai_enhance_memory_social
the incredible inventions of intuitive ai	inventions_ai
the jobs well lose to machines and the ones we wont	jobs_lose_machines
how new technology helps blind people explore the world	technology_blind_explore
design with the blind in mind	design_blind_mind
how technology allowed me to read	technology_read
our unhealthy obsession with choice	obsession_choice
how the hyperlink changed everything	hyperlink_everything
why the pencil is perfect	pencil_perfect
the genius of the london tube map	genius_london_tube_map
the 3000 year history of the hoodie	3000_year_history_hoodie
the hidden ways stairs shape your life	hidden_stairs_life
how the button changed fashion	button_fashion
how the jump rope got its rhythm	jump_rope_rhythm
bring on the female superheroes	female_superheroes
want to be an activist start with your toys	activist_start_toys
how i accidentally changed the way movies get made	changed_movies_made
how i use art to bridge misunderstanding	art_bridge_misunderstanding
the radical act of choosing common ground	act_common_ground
what happens when a silicon valley technologist works for the government	silicon_valley_works_government
try something new for 30 days	try_new_30_days
keep your goals to yourself	goals_yourself
how prefab homes can transform affordable housing	prefab_homes_affordable_housing
trusting the ensemble	trusting_ensemble
the mad scientist of music	scientist_music
hypnotic south asian improv music	south_asian_music
why you dont like the sound of your own voice	sound_own_voice
a test for parkinsons with a phone call	test_parkinsons_phone
alzheimers is not normal aging and we can cure it	alzheimers_aging_cure
what your breath could reveal about your health	breath_reveal_health
why having fun is the secret to a healthier life	fun_secret_healthier_life
how to discover your authentic self at any age	discover_authentic_self
how to break down barriers and not accept limits	break_barriers_limits
how to be a professional troublemaker	professional_troublemaker
the fight for civil rights and freedom	fight_civil_rights_freedom
the difference between being not racist and antiracist	difference_racist_antiracist
the path to ending systemic racism in the us	ending_systemic_racism
how we can make racism a solvable problem and improve policing	racism_solvable_policing
how to deconstruct racism one headline at a time	deconstruct_racism_headline
can you solve the prisoner hat riddle	solve_prisoner_hat_riddle
can you solve the vampire hunter riddle	solve_vampire_hunter_riddle
can you solve the giant iron riddle	solve_giant_iron_riddle
how im making bricks out of ashes and rubble in gaza	bricks_ashes_rubble_gaza
the warmth and wisdom of mud buildings	warmth_wisdom_buildings
will there ever be a milehigh skyscraper	milehigh_skyscraper
a reality check on renewables	reality_check_renewables
thorium an alternative nuclear fuel	thorium_alternative_fuel
how fear of nuclear power is hurting the environment	nuclear_power_environment
debate does the world need nuclear energy	debate_world_nuclear_energy
why light needs darkness	light_darkness
a project of peace painted across 50 buildings	project_peace_50_buildings
lets design social media that drives real change	design_social_media_change
online social change easy to organize hard to win	social_change_organize
got a smartphone start broadcasting	smartphone_broadcasting
government investor risktaker innovator	investor_risktaker
why we shouldnt trust markets with our civic life	trust_markets_civic
the case for letting business solve social problems	business_social_problems
a new kind of job market	new_job_market
making global labor fair	global_labor_fair
the other inconvenient truth	inconvenient
lets end ageism	end_ageism
four sisters in ancient rome	four_sisters_rome
did the amazons really exist	amazons_exist
meet the women fighting on the front lines of an american war	women_fighting_front_american_war
a new mission for veterans disaster relief	mission_veterans_disaster_relief
how women in pakistan are creating political change	women_pakistan_political_change
how pakistani women are taking the internet back	pakistani_women_internet
how we about sexual assault online talk	sexual_assault_talk
why i have coffee with people who send me hate mail	coffee_people_hate_mail
empathy is not endorsement	empathy_endorsement
inside the bizarre world of internet trolls and propagandists	internet_trolls_propagandists
governments dont understand cyber warfare we need hackers	governments_cyber_warfare_hackers
how to avoid surveillance with the phone in your pocket	avoid_surveillance_phone
government surveillance this is just the beginning	government_surveillance
your online life permanent as a tattoo	online_life_tattoo
the security mirage	security_mirage
fbi here i am	fbi
the nsa responds to edward snowdens ted talk	nsa_edward_snowdens_ted_talk
why privacy matters	privacy_matters
how the us government spies on people who protest including you	us_government_spies_people_protest
we can fight terror without sacrificing our rights	fight_terror_rights
why gun violence cant be our new normal	gun_violence_new_normal
4 lessons i learned from taking a stand against drugs and gun violence	4_lessons_stand_drugs_gun_violence
how christmas lights helped guerrillas put down their guns	christmas_lights_guerrillas_guns
what six years in captivity taught me about fear and faith	six_years_captivity_fear_faith
a letter to all who have lost in this era	letter_lost_era
a tale of two americas and the minimart where they collided	tale_two_americas_minimart
history vs christopher columbus	history_christopher_columbus
history vs henry viii	history_henry_viii
ugly history witch hunts	witch_hunts
why do people join cults	people_cults
is civility a sham	civility_sham
political common ground in a polarized united states	common_ground_united_states
should you live for your rsum or your eulogy	live_rsum_eulogy
the 4 stories we tell ourselves about death	4_stories_death
a philosophical quest for our biggest problems	philosophical_quest_problems
health and the human mind	health_human_mind
say your truths and seek them in others	truths_seek
an entertainment icon on living a life of meaning	entertainment_icon_meaning
my journey from marine to actor	journey_marine_actor
public art that turns cities into playgrounds of the imagination	art_cities_imagination
why art thrives at burning man	art_thrives_burning
inside africas thriving art scene	africas_art_scene
a visual history of social dance in 25 moves	visual_history_social_dance
the magic of khmer classical dance	magic_khmer_dance
the dancer the singer the cellist and a moment of creative magic	dancer_singer_cellist_creative_magic
the art of the interview	art_interview
why the live arts matter	live_arts
what does the future hold 11 characters offer quirky answers	future_11_characters_quirky_answers
there are no mistakes on the bandstand	mistakes_bandstand
watch me play the audience	play_audience
the optimism bias	optimism_bias
should you trust your first impression	trust_first_impression
the psychology behind irrational decisions	psychology_irrational_decisions
what is zenos dichotomy paradox	zenos_dichotomy_paradox
can you solve the multiplying rabbits riddle	solve_multiplying_rabbits_riddle
the secret structure of great talks	structure_great_talks
how to pitch to a vc	pitch_vc
how to find the person who can help you get ahead at work	find_person_help_work
know your worth and then ask for it	know_worth_ask
how to speak up for yourself	speak_yourself
3 lessons on success from an arab businesswoman	lessons_success_arab_businesswoman
confessions of a bad feminist	confessions_feminist
one woman five characters and a sex lesson from the future	one_woman_five_characters_sex_lesson
how porn changes the way teens think about sex	porn_teens_sex
how revenge porn turns lives upside down	revenge_porn_lives
its time for the law to protect victims of gender violence	law_protect_victims_gender_violence
how we can end sexual harassment at work	end_sexual_harassment
why women stay silent after sexual assault	women_silent_sexual_assault
to this day for the bullied and beautiful	bullied_beautiful
an electrifying acoustic guitar performance	acoustic_guitar_performance
space oddity	space_oddity
the art of asking	art_asking
a robot that runs and swims like a salamander	robot_runs_swims_salamander
why we will rely on robots	rely_robots
a robot that eats pollution	robot_eats_pollution
a climate change solution thats right under our feet	climate_change_solution
the disarming case to act right now on climate change	act_now_climate_change
why you should be a climate activist	be_climate_activist
how climate change affects your mental health	climate_change_mental_health
can we solve global warming lessons from how we protected the ozone layer	solve_global_warming_protected_ozone_layer
how to grow a glacier	grow_glacier
how we look kilometers below the antarctic ice sheet	look_kilometers_antarctic_ice
lets save the last pristine continent	save_continent
to the south pole and back the hardest 105 days of my life	south_pole_105_days_life
inside an antarctic time machine	antarctic_time_machine
never ever give up	never_give_up
the dangerous race for the south pole	race_south_pole
the joy of surfing in icecold water	joy_surfing_icecold
a lyrical bridge between past present and future	lyrical_bridge_past_future
4 powerful poems about parkinsons and growing older	4_poems_parkinsons
a brief history of melancholy	history_melancholy
how stress affects your body	stress_body
how to make stress your friend	stress_friend
why we get mad and why its healthy	mad_healthy
you arent at the mercy of your emotions your brain creates them	mercy_emotions_brain_creates
the history of human emotions	history_emotions
this app knows how you feel from the look on your face	app_feel_look_face
how were teaching computers to understand pictures	teaching_computers_pictures
the wonderful and terrifying implications of computers that can learn	terrifying_implications_computers
wheres google going next	google_next
why google glass	google_glass
adjustable liquidfilled eyeglasses	liquidfilled_eyeglasses
one second every day	second_day
the internet could crash we need a plan b	internet_crash_plan_b
back to the future of 1994	back_future_1994
understanding cancer through proteomics	cancer_proteomics
discover the physical side of the internet	physical_internet
wireless data from every light bulb	wireless_data_bulb
the wireless future of medicine	wireless_medicine
the big idea my brother inspired	idea_brother_inspired
a new way to monitor vital signs that can see through walls	monitor_vital_through_walls
what intelligent machines can learn from a school of fish	intelligent_machines_learn_fish
can a robot pass a university entrance exam	robot_university_entrance
what would happen if we upload our brains to computers	upload_brains_computers
how do we find dignity at work	dignity_work
10 things you didnt know about orgasm	10_things_orgasm
the virginity fraud	virginity_fraud
the uncomplicated truth about womens sexuality	truth_womens_sexuality
how to have a healthier positive relationship to sex	positive_relationship_sex
the evolution of animal genitalia	evolution_animal_genitalia
meet the tardigrade the toughest animal on earth	tardigrade_toughest_animal
why are sloths so slow	sloths_slow
how do dogs see with their noses	dogs_see_noses
howe a brief history of dogs	howe_history_dogs
sloths the strange life of the worlds slowest mammal	sloths_slowest_mammal
how trees to each other talk	trees_talk
why wildfires have gotten worse and what we can do about it	wildfires_worse_about
the story we tell about millennials and who we leave out	story_millennials_leave
what baby boomers can learn from millennials at work and vice versa	baby_boomers_learn_millennials
how diversity makes teams more innovative	diversity_teams_innovative
what the people of the amazon know that you dont	people_amazon_know
how language transformed humanity	language_humanity
where did english come from	english_from
how centuries of scifi sparked spaceflight	centuries_scifi_spaceflight
where are all the aliens	where_aliens
the story of oumuamua the first visitor from another star system	story_oumuamua_visitor_star
how radio telescopes show us unseen galaxies	radio_telescopes_unseen_galaxies
the most detailed map of galaxies black holes and stars ever made	detailed_map_black_holes
a rare galaxy thats challenging our understanding of the universe	galaxy_challenging_understanding_universe
